james	m
robert	m
michael	m
william	m
david	m
richard	m
charles	m
joseph	m
thomas	m
john	m
christopher	m
linda	f
daniel	m
elizabeth	f
jennifer	f
donald	m
kenneth	m
susan	f
edward	m
margaret	f
dorothy	f
ronald	m
anthony	m
matthew	m
timothy	m
sandra	f
chris	m
jeffrey	m
stephen	m
mike	m
sarah	f
lisa	f
jason	m
jessica	f
raymond	m
kevin	m
brian	m
melissa	f
andrew	m
maria	f
jerry	m
virginia	f
rebecca	f
joe	m
martha	f
mark	m
paul	m
amanda	f
michelle	f
patrick	m
eric	m
jonathan	m
christine	f
peter	m
catherine	f
douglas	m
henry	m
joyce	f
ann	f
alice	f
nicole	f
alex	m
steven	m
arthur	m
stephanie	f
jose	m
albert	m
mildred	f
katherine	f
gerald	m
samuel	m
karen	f
judith	f
matt	m
rose	f
laura	f
frank	m
adam	m
janice	f
steve	m
lawrence	m
christina	f
nicholas	m
theresa	f
benjamin	m
ryan	m
sean	m
barbara	f
irene	f
jane	f
lauren	f
scott	m
george	m
nick	m
justin	m
carlos	m
luis	m
eugene	m
amy	f
louise	f
julia	f
rachel	f
jeff	m
tom	m
nancy	f
anna	f
paula	f
dan	m
danielle	f
martin	m
diana	f
ernest	m
emily	f
angela	f
alan	m
ashley	f
florence	f
donna	f
denise	f
philip	m
juan	m
jay	m
tony	m
andrea	f
leonard	m
danny	m
curtis	m
victoria	f
edith	f
sylvia	f
ellen	f
kelly	f
marvin	m
rob	m
samantha	f
charlotte	f
esther	f
kim	f
carol	f
sharon	f
joshua	m
alfred	m
vanessa	f
francis	m
jim	m
eva	f
ben	m
victor	m
julie	f
gary	m
herbert	m
frederick	m
bill	m
diane	f
greg	m
tiffany	f
kimberly	f
sara	f
eleanor	f
katie	f
marc	m
josh	m
tim	m
bertha	f
dave	m
aaron	m
geraldine	f
heather	f
keith	m
vincent	m
jack	m
michele	f
jon	m
sam	m
lorraine	f
erica	f
kathy	f
regina	f
andy	m
alexander	m
erin	f
beatrice	f
deborah	f
dennis	m
jenny	f
marie	f
bernard	m
liz	f
ana	f
leroy	m
eddie	m
marcus	m
clifford	m
cynthia	f
kate	f
brandon	m
jeremy	m
anne	f
debbie	f
roberta	f
jacqueline	f
gregory	m
jeanette	f
calvin	m
janet	f
jackie	f
gina	f
carmen	f
dawn	f
kathleen	f
tara	f
jimmy	m
joel	m
bob	m
natalie	f
wendy	f
larry	m
jeanne	f
monica	f
crystal	f
joanne	f
craig	m
pamela	f
rosemary	f
jorge	m
cindy	f
shawn	m
ken	m
kyle	m
megan	f
tina	f
bryan	m
gertrude	f
angel	m
johnny	m
allison	f
jesse	m
ian	m
valerie	f
joey	m
zachary	m
miguel	m
agnes	f
natasha	f
lori	f
andre	m
louis	m
alicia	f
delores	f
ray	m
judy	f
kristen	f
robin	f
ron	m
lester	m
constance	f
helen	f
cathy	f
jill	f
veronica	f
edwin	m
jamie	f
evelyn	f
tracy	f
gilbert	m
cheryl	f
will	m
dana	f
mario	m
maureen	f
rich	m
eileen	f
rick	m
beth	f
caroline	f
debra	f
melanie	f
carolyn	f
tommy	m
stacey	f
billy	m
bobby	m
evan	m
antonio	m
grace	f
max	m
rafael	m
claudia	f
jordan	m
leslie	m
bruce	m
omar	m
charlie	m
mabel	f
chester	m
renee	f
tanya	f
todd	m
franklin	m
kristin	f
brenda	f
hector	m
derek	m
jasmine	f
elaine	f
kenny	m
annie	f
gabriel	m
erika	f
gloria	f
monique	f
jen	f
cassandra	f
roland	m
suzanne	f
ricardo	m
naomi	f
erik	m
sonia	f
jake	m
alison	f
sandy	f
joanna	f
ivan	m
fred	m
carl	m
ralph	m
nina	f
shannon	f
marilyn	f
julio	m
adrian	m
lindsay	f
ruth	f
phil	m
neil	m
christian	m
randy	m
teresa	f
don	m
gail	f
sheila	f
stacy	f
lucy	f
nikki	f
barry	m
wayne	m
fernando	m
yvonne	f
brittany	f
oscar	m
elena	f
courtney	f
travis	m
laurie	f
jacob	m
roger	m
alexis	f
jean	f
nelson	m
rosa	f
annette	f
rita	f
belinda	f
marco	m
howard	m
miriam	f
harry	m
pete	m
maggie	f
lynn	f
brad	m
pedro	m
doug	m
sabrina	f
ricky	m
joann	f
simon	m
roberto	m
jared	m
harriet	f
wallace	m
leah	f
yolanda	f
seth	m
brendan	m
francisco	m
walter	m
corey	m
colleen	f
marina	f
yvette	f
manuel	m
vivian	f
nathan	m
anita	f
arlene	f
kristina	f
josephine	f
felix	m
april	f
javier	m
amelia	f
lee	m
wanda	f
carla	f
emma	f
olga	f
genevieve	f
candace	f
iris	f
julian	m
joy	f
claire	f
tamara	f
alyssa	f
camille	f
tyler	m
leo	m
ali	m
sue	f
olivia	f
felicia	f
glenn	m
allen	m
carrie	f
angie	f
jenna	f
brett	m
cesar	m
bonnie	f
dwayne	m
angelo	m
andres	m
darren	m
phyllis	f
hannah	f
alberto	m
sal	m
pat	f
betty	f
chad	m
ted	m
toni	f
simone	f
sally	f
latoya	f
cristina	f
peggy	f
luke	m
diego	m
phillip	m
johanna	f
salvatore	m
dina	f
tracey	f
keisha	f
russell	m
isaac	m
richie	m
nadia	f
drew	m
manny	m
troy	m
ramon	m
amber	f
marcia	f
carolina	f
vinny	m
connie	f
natalia	f
edgar	m
derrick	m
shane	m
colin	m
audrey	f
holly	f
desiree	f
kathryn	f
meghan	f
adriana	f
roy	m
maurice	m
adrienne	f
marlene	f
trevor	m
bianca	f
rosemarie	f
raquel	f
karina	f
marissa	f
beverly	f
meredith	f
luz	f
heidi	f
lillian	f
zach	m
stanley	m
alexandra	f
jerome	m
frankie	m
tyrone	m
sergio	m
eduardo	m
jillian	f
ingrid	f
nadine	f
ruben	m
kerry	f
terry	m
jesus	m
jodi	f
ebony	f
raul	m
madeline	f
tricia	f
janine	f
lindsey	f
angelina	f
doreen	f
sasha	f
molly	f
tammy	f
ariel	m
gene	m
sebastian	m
lily	f
marlon	m
angelica	f
marisa	f
pablo	m
wilbur	m
dean	m
caitlin	f
francesca	f
tatiana	f
maryann	f
katrina	f
rodney	m
mohamed	m
shaun	m
harold	m
jessie	f
doris	f
lydia	f
leon	m
fran	f
patty	f
vicky	f
chuck	m
daisy	f
marisol	f
stuart	m
allan	m
erick	m
kelvin	m
bernadette	f
gerard	m
norma	f
brooke	f
rudolph	m
eli	m
giovanni	m
jaime	m
daniela	f
alejandro	m
abby	f
betsy	f
junior	m
sherry	f
warren	m
irina	f
jamal	m
priscilla	f
mitchell	m
becky	f
darlene	f
sophia	f
randolph	m
wilson	m
charlene	f
ross	m
dominique	f
ahmed	m
jermaine	m
oliver	m
freddy	m
antoinette	f
cecilia	f
ethan	m
mia	f
lance	m
paola	f
dominick	m
orlando	m
noah	m
henrietta	f
damian	m
mohammed	m
marsha	f
darryl	m
rhonda	f
candice	f
isabel	f
dylan	m
nate	m
robyn	f
krystal	f
jenn	f
francine	f
nicolas	m
guy	m
edmund	m
spencer	m
nora	f
kurt	m
kara	f
stella	f
alvin	m
noel	m
melinda	f
lou	m
kareem	m
gladys	f
cara	f
tasha	f
cedric	m
lina	f
sophie	f
marcos	m
karl	m
shari	f
xavier	m
margarita	f
maritza	f
elisa	f
norman	m
terrence	m
liza	f
elsa	f
sylvester	m
lenny	m
stefanie	f
melvin	m
pam	f
mindy	f
kristine	f
terri	f
marianne	f
ari	m
marjorie	f
june	f
vladimir	m
whitney	f
bridget	f
winifred	f
avi	m
chelsea	f
enrique	m
ronnie	m
nathaniel	m
shelly	f
karla	f
taylor	f
stefan	m
pierre	m
dee	f
jocelyn	f
lucas	m
roman	m
sammy	m
aisha	f
jess	f
devon	m
sofia	f
amit	m
austin	m
stan	m
vicki	f
igor	m
gustavo	m
mimi	f
willie	m
boris	m
jasmin	f
brent	m
carole	f
adele	f
abigail	f
woodrow	m
lucinda	f
levi	m
benny	m
cory	m
tania	f
alexa	f
shana	f
rene	m
maya	f
tamika	f
gabriela	f
marta	f
dominic	m
jaclyn	f
jeannette	f
rachael	f
alfredo	m
estella	f
laurence	m
helene	f
mercedes	f
mitch	m
rosie	f
teddy	m
gregg	m
giselle	f
bradley	m
pauline	f
patrice	f
deanna	f
dolores	f
jennie	f
reginald	m
annmarie	f
roxanne	f
melody	f
israel	m
millie	f
mohammad	m
wilfred	m
mayra	f
mandy	f
mona	f
kirk	m
zack	m
cristian	m
silvia	f
yesenia	f
marty	m
prince	m
christy	f
randi	f
lara	f
devin	m
sheldon	m
alonzo	m
ira	m
lois	f
deirdre	f
king	m
neal	m
rudy	m
gordon	m
leonardo	m
meg	f
carly	f
lady	f
jeannie	f
tonya	f
justine	f
celeste	f
rochelle	f
fabian	m
marion	f
morgan	f
mauricio	m
janelle	f
alana	f
elise	f
lourdes	f
kat	f
elliot	m
jamel	m
aida	f
anton	m
louie	m
loretta	f
bradford	m
kimberley	f
cornelius	m
clara	f
damon	m
lloyd	m
malik	m
zoe	f
lissette	f
glen	m
owen	m
damien	m
jeanine	f
kayla	f
milton	m
duane	m
kris	m
reggie	m
maribel	f
amir	m
lynne	f
moshe	m
sheryl	f
dianne	f
mikey	m
moses	m
elvis	m
denis	m
shelley	f
giuseppe	m
chloe	f
antoine	m
marian	f
nigel	m
abraham	m
lana	f
casey	m
kay	f
lena	f
hugo	m
chrissy	f
eddy	m
corinne	f
ivy	f
fatima	f
patti	f
wesley	m
cliff	m
hope	f
mariana	f
darrell	m
terence	m
cecile	f
elijah	m
isabelle	f
emanuel	m
raphael	m
krista	f
margie	f
liam	m
kerri	f
aimee	f
ruby	f
gabe	m
felipe	m
cameron	m
katy	f
monika	f
rodrigo	m
stephan	m
lynda	f
malcolm	m
blake	m
armando	m
winston	m
nathalie	f
jan	m
luisa	f
kristy	f
christie	f
tanisha	f
hassan	m
young	m
bella	f
emmanuel	m
adeline	f
elias	m
penny	f
raj	m
darnell	m
juanita	f
perry	m
carlo	m
kendra	f
abdul	m
arnold	m
ilya	m
syed	m
maxine	f
brianna	f
dustin	m
ivette	f
faith	f
lucia	f
nelly	f
georgia	f
guillermo	m
dwight	m
alisha	f
harvey	m
isaiah	m
johnathan	m
vito	m
paige	f
gus	m
gabriella	f
leigh	f
yael	f
alisa	f
susie	f
leticia	f
nichole	f
mari	f
lamont	m
rodger	m
margret	f
gabrielle	f
cathleen	f
bruno	m
dale	m
mustafa	m
hilary	f
garrett	m
gil	m
byron	m
hillary	f
lola	f
fiona	f
trisha	f
alejandra	f
damaris	f
earl	m
roseann	f
carmine	m
charmaine	f
cassie	f
sunny	m
daniella	f
ernesto	m
cody	m
sheena	f
vince	m
elisabeth	f
gavin	m
lewis	m
julissa	f
vera	f
candy	f
arielle	f
ravi	m
lorenzo	m
geoffrey	m
wilfredo	m
lucille	f
winnie	f
daryl	m
kirsten	f
cleveland	m
aileen	f
ilana	f
karin	f
jade	f
gretchen	f
lorena	f
rocco	m
rahul	m
edna	f
sonya	f
juliet	f
theodore	m
dexter	m
lesley	f
ellie	f
liliana	f
alina	f
paulette	f
ella	f
bryant	m
miranda	f
antonia	f
latisha	f
matilda	f
bettye	f
cornelia	f
agustin	m
beatriz	f
rosalie	f
kenya	f
hilda	f
trina	f
milagros	f
josie	f
elyse	f
hugh	m
jody	f
daphne	f
luigi	m
yelena	f
francesco	m
dante	m
saul	m
jana	f
mara	f
fabio	m
alfonso	m
missy	f
allie	f
lionel	m
ramona	f
julius	m
terrance	m
celia	f
myrna	f
ahmad	m
kelli	f
helena	f
robbie	m
sherri	f
geoff	m
alec	m
renata	f
muhammad	m
keri	f
carmela	f
sheri	f
flossie	f
minerva	f
nelda	f
elnora	f
priya	f
noreen	f
ilene	f
gwen	f
dara	f
becca	f
noelle	f
blanca	f
emilio	m
tristan	m
rachelle	f
jayson	m
andreas	m
grant	m
luca	m
ada	f
yana	f
asia	f
lynette	f
alma	f
valentina	f
gerardo	m
lea	f
ariana	f
desmond	m
yasmin	f
ismael	m
philippe	m
ava	f
may	f
marcel	m
terrell	m
jeannine	f
allyson	f
ida	f
kelsey	f
deb	f
caleb	m
trish	f
inna	f
abe	m
serena	f
elwood	m
eve	f
pearlie	f
zelma	f
solomon	m
penelope	f
nannie	f
hans	m
gigi	f
stacie	f
vlad	m
rory	m
paolo	m
graham	m
santiago	m
kai	m
angelique	f
irma	f
marcelo	m
elana	f
kellie	f
glenda	f
arturo	m
mel	m
bethany	f
lamar	m
mehmet	m
samir	m
marcy	f
svetlana	f
magdalena	f
nana	f
alvaro	m
chanel	f
kisha	f
vincenzo	m
tomas	m
alissa	f
carlton	m
dmitriy	m
fanny	f
miles	m
marcela	f
nicola	f
kari	f
elliott	m
rocky	m
german	m
laurel	f
sergey	m
rohan	m
marshall	m
chaim	m
imran	m
romeo	m
rey	m
clarence	m
johan	m
thaddeus	m
jackson	m
rosalinda	f
louisa	f
earnestine	f
althea	f
kristi	f
brittney	f
raven	f
karim	m
willy	m
alexandria	f
vickie	f
briana	f
gayle	f
jayne	f
dianna	f
mathew	m
athena	f
tabitha	f
maura	f
brandi	f
kwame	m
teri	f
tyrell	m
anil	m
giovanna	f
rosanna	f
hank	m
jairo	m
vernon	m
timmy	m
tisha	f
deejay	m
valeria	f
jonny	m
theo	m
kiki	f
oleg	m
shanna	f
randall	m
sonny	m
gwendolyn	f
jeremiah	m
julien	m
preston	m
marianna	f
michel	m
lilly	f
bernice	f
russ	m
clare	f
fabiola	f
farah	f
tito	m
elissa	f
dario	m
toby	m
kira	f
myra	f
yossi	m
suzette	f
kent	m
claudio	m
marla	f
leila	f
shira	f
hanna	f
darius	m
howie	m
moe	m
eliza	f
mariela	f
ally	f
damion	m
juliana	f
loyd	m
jin	m
susana	f
elvin	m
serge	m
kaitlin	f
stefano	m
rolando	m
ayana	f
dionne	f
jun	m
martina	f
kelley	f
alain	m
krystle	f
alessandro	m
vadim	m
donovan	m
gerry	m
esteban	m
jonah	m
?brahim	m
meaghan	f
mickey	m
morris	m
meagan	f
hayley	f
chase	m
sade	f
vishal	m
lia	f
latasha	f
tia	f
dani	f
hunter	m
dora	f
josue	m
sydney	f
susanne	f
dino	m
viviana	f
margo	f
hal	m
dmitry	m
blair	f
ginger	f
colette	f
kaitlyn	f
freddie	m
nicky	m
shani	f
larissa	f
alla	f
noemi	f
art	m
caryn	f
tatyana	f
murat	m
phoebe	f
libby	f
chantal	f
judi	f
wade	m
akeem	m
alyson	f
magda	f
alessandra	f
paulo	m
mikhail	m
migdalia	f
len	m
brandy	f
jonas	m
karyn	f
shaniqua	f
delia	f
jazmine	f
shauna	f
franco	m
maryanne	f
dane	m
xiomara	f
denny	m
jefferson	m
rosanne	f
susanna	f
basil	m
anastasia	f
clement	m
destiny	f
dimitri	m
rina	f
mei	f
jacquelyn	f
nico	m
clint	m
milena	f
katerina	f
moises	m
sanjay	m
eleni	f
emil	m
nilda	f
aldo	m
shoshana	f
vaughn	m
wes	m
chantel	f
garry	m
connor	m
deidre	f
conrad	m
rena	f
lorna	f
shawna	f
selena	f
lisette	f
loren	f
wei	m
tameka	f
robby	m
precious	f
steph	f
ivonne	f
donny	m
stewart	m
ronny	m
efrain	m
tamar	f
eunice	f
aviva	f
eugenia	f
jude	m
traci	f
herman	m
venus	f
jazmin	f
sonja	f
audra	f
jacques	m
lenore	f
ajay	m
anya	f
olivier	m
harris	m
rosalind	f
elsie	f
meryl	f
gino	m
pearl	f
hasan	m
claude	m
chandra	f
gaby	f
rebekah	f
maxwell	m
gilberto	m
ernie	m
carissa	f
kamal	m
les	m
errol	m
selina	f
nellie	f
rohit	m
ashish	m
siobhan	f
maryellen	f
federico	m
eliana	f
flora	f
diamond	f
dena	f
tami	f
talia	f
abel	m
marcella	f
niki	f
annemarie	f
mina	f
carmelo	m
summer	f
collin	m
darwin	m
bart	m
millicent	f
mary	f
hester	f
genesis	f
alexandre	m
liana	f
jae	m
jamila	f
oren	m
kitty	f
emilie	f
suzy	f
geri	f
kristian	m
caren	f
bernie	m
chip	m
margot	f
cherry	f
sidney	m
hazel	f
christa	f
alanna	f
avery	m
julianne	f
cat	f
anderson	m
fernanda	f
wendell	m
tariq	m
lashawn	f
irving	m
jamaal	m
micheal	m
tessa	f
ayesha	f
tawana	f
charisse	f
sunil	m
clinton	m
alba	f
tess	f
faye	f
ursula	f
yuliya	f
michal	f
sameer	m
jing	f
conor	m
myriam	f
harrison	m
clarissa	f
shantel	f
haley	f
kia	f
michaela	f
aron	m
racquel	f
antonella	f
janette	f
shelby	f
lizzie	f
violet	f
sandeep	m
petra	f
vijay	m
vivek	m
clay	m
sami	m
ericka	f
joelle	f
indira	f
lili	f
brigitte	f
johnson	m
kristie	f
joaquin	m
tyson	m
nia	f
quincy	m
britney	f
aleksandra	f
clyde	m
katia	f
ying	f
larisa	f
nisha	f
camilo	m
camila	f
abhishek	m
yan	m
ginny	f
roxana	f
khalid	m
bert	m
omer	m
silvana	f
elvira	f
ashleigh	f
trey	m
ashlee	f
lilian	f
reynaldo	m
rod	m
roslyn	f
shante	f
lizette	f
martine	f
tori	f
jodie	f
trudy	f
daria	f
faisal	m
numbers	m
isabella	f
rocio	f
adelaide	f
celina	f
joan	m
adan	m
wilford	m
doretha	f
gayla	f
gussie	f
letitia	f
dessie	f
reuben	m
kasia	f
amina	f
ayanna	f
coco	f
andrey	m
mira	f
yahaira	f
vilma	f
cole	m
awilda	f
gaurav	m
rex	m
quentin	m
yung	m
kristopher	m
marquis	m
min	f
vin	m
taryn	f
gabby	f
lin	f
adina	f
jacky	m
katelyn	f
shakira	f
georgina	f
madelyn	f
sandi	f
gia	f
andrei	m
jamar	m
anand	m
tonia	f
dolly	f
logan	m
ezra	m
cherie	f
davon	m
artie	m
claudette	f
reina	f
demetrius	m
hernan	m
nestor	m
ria	f
ahmet	m
tiara	f
ami	f
dion	m
mariano	m
marguerite	f
amar	m
imani	f
madison	f
massimo	m
jeffery	m
shayna	f
donnie	m
luciano	m
iliana	f
aliza	f
inez	f
carina	f
debby	f
anika	f
jessy	f
arianna	f
haydee	f
laurent	m
clayton	m
brooklyn	m
jeanie	f
octavia	f
ignacio	m
hana	f
trent	m
katharine	f
ciara	f
dayna	f
flor	f
oksana	f
mariel	f
duncan	m
pavel	m
deepak	m
dorian	m
juliette	f
markus	m
marybeth	f
elba	f
debora	f
rishi	m
jo-ann	f
veronika	f
edison	m
jessenia	f
mallory	f
asha	f
kenia	f
fausto	m
pilar	f
greta	f
tiana	f
hakan	m
galina	f
bernardo	m
arleen	f
zak	m
yadira	f
princess	f
brianne	f
sharlene	f
rico	m
cecil	m
aurora	f
clark	m
ekaterina	f
niko	m
sabina	f
rosalyn	f
mollie	f
tee	f
jed	m
claudine	f
alexia	f
sondra	f
chana	f
aidan	m
rajiv	m
karolina	f
lucky	m
mariya	f
zoraida	f
yehuda	m
verda	f
maudie	f
tillie	f
hortencia	f
wilburn	m
delilah	f
retha	f
wilhelmina	f
virgina	f
mervin	m
kavita	f
leandro	m
marcello	m
elle	f
stephany	f
jelani	m
emilia	f
roderick	m
marci	f
santos	m
manuela	f
shaquana	f
luciana	f
lakisha	f
enid	f
leanne	f
ines	f
kunal	m
ming	m
dick	m
wil	m
vic	m
tarik	m
lora	f
adnan	m
nikita	f
juana	f
kiara	f
pia	f
sunita	f
katya	f
neha	f
mariam	f
fritz	m
jenifer	f
madeleine	f
gonzalo	m
jamil	m
shay	f
matteo	m
dillon	m
kieran	m
nakia	f
lidia	f
rajesh	m
rashad	m
estelle	f
arun	m
lila	f
paris	f
samara	f
myles	m
sabine	f
ace	m
kofi	m
roseanne	f
agnieszka	f
soraya	f
bilal	m
jovan	m
sari	f
konstantin	m
cris	m
lexi	f
jhon	m
jonathon	m
rami	m
bryce	m
asif	m
nydia	f
elina	f
irwin	m
nicolette	f
chaya	f
johnnie	m
shavon	f
denisse	f
mauro	m
felice	f
yong	m
marko	m
rosario	f
alon	m
astrid	f
jarrod	m
rodolfo	m
lars	m
bridgette	f
seema	f
emre	m
lord	m
barney	m
dom	m
edgardo	m
christos	m
stu	m
reed	m
nat	m
micah	m
yuri	m
mariah	f
jewel	f
carlene	f
jarrett	m
cyrus	m
cecelia	f
giancarlo	m
suzie	f
clive	m
donnell	m
coleen	f
melisa	f
bibi	f
autumn	f
melina	f
thea	f
cherise	f
frederic	m
yoni	m
franz	m
nicki	f
yuki	f
julianna	f
izzy	m
mac	m
rashid	m
meir	m
erwin	m
esmeralda	f
bettina	f
barbie	f
edmond	m
alena	f
marcin	m
lincoln	m
antony	m
ilona	f
kendall	m
reid	m
domenico	m
janis	f
black	m
kadeem	m
varun	m
thom	m
mehdi	m
vinnie	m
tali	f
gemma	f
sid	m
lulu	f
carter	m
tal	m
dorris	f
mayme	f
vesta	f
elouise	f
tomasa	f
lyman	m
reta	f
vada	f
delois	f
belva	f
dominga	f
berniece	f
leota	f
roxanna	f
gillian	f
kieth	m
josiah	m
normand	m
lemuel	m
paulina	f
lura	f
margarito	m
chaz	m
alix	f
humberto	m
justina	f
farrah	f
amie	f
therese	f
renato	m
clifton	m
usman	m
frantz	m
maryam	f
janie	f
catalina	f
darin	m
danilo	m
taisha	f
domingo	m
chen	m
roxy	f
kasey	f
gianni	m
mai	f
lakeisha	f
jenni	f
india	f
noelia	f
adolfo	m
risa	f
lizbeth	f
fay	f
anny	f
salvador	m
deena	f
franklyn	m
francois	m
brendon	m
bree	f
ileana	f
malika	f
yves	m
adrianne	f
thierry	m
joanie	f
jacqui	f
wally	m
red	m
karan	m
kesha	f
yessenia	f
rebeca	f
dre	m
gianna	f
asher	m
ruthie	f
lukas	m
abbey	f
deana	f
manish	m
beata	f
roni	f
matty	m
jasper	m
muriel	f
sachin	m
zac	m
stefani	f
beau	m
aja	f
artur	m
delroy	m
aleksandr	m
simona	f
akiko	f
camilla	f
wilma	f
piotr	m
christophe	m
milly	f
domenick	m
nino	m
tracie	f
dima	m
kathie	f
yajaira	f
flavia	f
ivana	f
davide	m
ilan	m
ina	f
samira	f
osvaldo	m
val	f
axel	m
ankur	m
rhea	f
kashif	m
marge	f
layla	f
lyn	f
maurizio	m
dahlia	f
jian	m
elie	m
sky	m
shanell	f
reena	f
uri	m
deidra	f
curt	m
gisela	f
cheri	f
enrico	m
kamil	m
yulia	f
lev	m
taina	f
masha	f
keshia	f
reinaldo	m
joao	m
darrin	m
callie	f
thelma	f
polly	f
mae	f
kylie	f
shameka	f
van	m
vikram	m
bobbi	f
jojo	m
gideon	m
remy	m
nalini	f
pasquale	m
janel	f
gale	f
horace	m
otto	m
mendy	m
sadie	f
starr	f
marcie	f
eliezer	m
ivelisse	f
keiko	f
jenelle	f
darcy	f
ariella	f
navin	m
pastor	m
esperanza	f
raheem	m
krissy	f
nilsa	f
solange	f
ike	m
aubrey	m
yusuf	m
sherman	m
floyd	m
debi	f
riley	m
effie	f
dong	m
herb	m
paulie	m
javon	m
akil	m
ting	f
janna	f
leona	f
nan	f
johana	f
amalia	f
maddy	f
emmy	f
ram	m
rafi	m
laverne	f
sandro	m
minnie	f
artem	m
onur	m
nikhil	m
cem	m
buddy	m
janina	f
mathieu	m
gee	m
duke	m
raja	m
adrianna	f
lex	m
cristal	f
anabel	f
annabelle	f
mamadou	m
ronni	f
angeline	f
dalia	f
yuriy	m
leyla	f
lukasz	m
ann-marie	f
shamika	f
constantine	m
mick	m
staci	f
archie	m
hubert	m
khalil	m
mercy	f
mila	f
irena	f
rashida	f
rae	f
polina	f
sebastien	m
cordelia	f
newton	m
zachariah	m
rolland	m
dortha	f
orval	m
robt	m
odis	m
verla	f
melvina	f
lawerence	m
olen	m
adell	f
burl	m
chauncey	m
marlys	f
valorie	f
hildegard	f
myrtis	f
frances	m
tobias	m
shirley	m
augustus	m
oleta	f
gregoria	f
columbus	m
abram	m
dovie	f
florencio	m
raleigh	m
herlinda	f
mason	m
rommel	m
yosef	m
marietta	f
yakov	m
bret	m
yanira	f
gracie	f
reza	m
tiffani	f
roz	f
andi	f
fern	f
rosalia	f
amaury	m
salman	m
nitin	m
laila	f
josefina	f
fallon	f
aditya	m
yoko	f
sterling	m
caridad	f
annamarie	f
rhoda	f
rasheed	m
cari	f
pooja	f
adi	f
gio	m
mika	f
samson	m
pascal	m
carey	f
rakesh	m
jesenia	f
toniann	f
keren	f
zina	f
anjali	f
mahmoud	m
reyna	f
kingsley	m
garfield	m
shaina	f
maja	f
eduard	m
fredrick	m
gena	f
jonelle	f
cecily	f
shlomo	m
dori	f
khaled	m
neville	m
ling	f
kiana	f
naima	f
celine	f
shah	m
murray	m
gareth	m
sherrie	f
cora	f
cori	f
saurabh	m
prashant	m
keila	f
jada	f
nataly	f
luna	f
aziz	m
alecia	f
priyanka	f
tenzin	m
mat	m
cyndi	f
franchesca	f
viktor	m
stefania	f
sharyn	f
nik	m
katty	f
perla	f
jami	f
ethel	f
fabrizio	m
latonya	f
derick	m
deshawn	m
pawel	m
?smail	m
osman	m
pietro	m
mirna	f
hakeem	m
amr	m
guillaume	m
geo	m
chi	m
love	f
pascale	f
anibal	m
samia	f
bennett	m
everett	m
lizzy	f
dinesh	m
parker	m
farhan	m
jeanmarie	f
seamus	m
everton	m
ewa	f
yasmine	f
corrine	f
annamaria	f
yuko	f
riccardo	m
cary	m
arnaud	m
shmuel	m
toya	f
livia	f
eliot	m
portia	f
alia	f
marni	f
natacha	f
nanette	f
claribel	f
violeta	f
otis	m
misha	m
omari	m
aline	f
lynnette	f
tanika	f
concetta	f
fatih	m
kimmy	f
branden	m
florian	m
chiara	f
erich	m
isis	f
ashanti	f
naveen	m
veronique	f
leidy	f
yaniv	m
christoph	m
stephane	m
daniele	m
slava	m
keesha	f
jaimie	f
shanta	f
lala	f
marva	f
evie	f
joni	f
massiel	f
nereida	f
colby	m
serkan	m
ned	m
burt	m
graciela	f
mateo	m
adrien	m
lacey	f
vikas	m
nabil	m
aura	f
milan	m
kristal	f
wellington	m
anais	f
valentin	m
katina	f
vance	m
eyal	m
sierra	f
nolan	m
franck	m
zaida	f
georgette	f
ric	m
woody	m
nichelle	f
jia	f
thalia	f
sang	m
sana	f
quinn	m
elyssa	f
ervin	m
khadijah	f
eun	f
alen	m
lyle	m
fabiana	f
aman	m
inga	f
khadija	f
wing	m
sherwin	m
davis	m
agata	f
vincenza	f
priscila	f
selma	f
vinay	m
belkis	f
kenji	m
lauri	f
ximena	f
mohit	m
marius	m
katarzyna	f
noa	f
lissa	f
sylvie	f
sharif	m
angelika	f
chantelle	f
rowena	f
marylou	f
kati	f
kit	f
lior	m
augusto	m
carmel	f
hakim	m
rosy	f
alaina	f
rusty	m
rony	m
domenic	m
bobbie	f
charity	f
shameeka	f
janeen	f
evans	m
beverley	f
jordana	f
garth	m
suzana	f
caitlyn	f
jacklyn	f
abdullah	m
edouard	m
elan	m
chanelle	f
rafaela	f
monte	m
natalya	f
preeti	f
brigid	f
amin	m
ashton	m
magaly	f
ramesh	m
robb	m
salma	f
elaina	f
chirag	m
gisele	f
ash	m
ester	f
bea	f
indra	f
lennox	m
h?ng	m
mahesh	m
akash	m
sol	f
shanelle	f
jacquie	f
mack	m
joana	f
kin	m
jena	f
aya	f
anuj	m
mariko	f
yaron	m
kev	m
rona	f
marlena	f
josette	f
britt	f
justyna	f
nir	m
tanja	f
asad	m
kerry-ann	f
enzo	m
maia	f
sergei	m
gaetano	m
arnie	m
kyra	f
dany	m
leonel	m
vivien	f
han	m
corina	f
xiao	f
ganesh	m
shimon	m
tomer	m
brady	m
alton	m
eitan	m
suzan	f
jayme	f
unique	f
shanice	f
skye	f
kyla	f
lizzette	f
kwesi	m
jessi	f
jelena	f
lisbeth	f
lyndsey	f
kimberlee	f
misty	f
sumit	m
spiro	m
lisandra	f
filippo	m
saundra	f
chet	m
stephon	m
eran	m
chelsey	f
sheree	f
oneil	m
tyron	m
kirill	m
ronda	f
eden	f
viola	f
raina	f
miki	f
yoel	m
divya	f
scarlett	f
denice	f
ramy	m
caterina	f
savannah	f
shea	f
just	m
raisa	f
franky	m
shamel	m
rashawn	m
hong	m
ardith	f
mittie	f
sanjuana	f
benedict	m
hermelinda	f
ardis	f
harland	m
josephina	f
blanch	f
sherrill	f
hobert	m
arnoldo	m
eldridge	m
jeramy	m
zackary	m
maybelle	f
asa	m
elden	m
rayford	m
sanjuanita	f
patricia	m
otha	m
jerrie	f
cherly	f
michale	m
susannah	f
arlie	m
lovie	f
felicitas	f
claud	m
enriqueta	f
linnie	f
winnifred	f
orpha	f
vergie	f
elenor	f
ezekiel	m
filiberto	m
winford	m
kyong	f
mose	m
candelaria	f
yolonda	f
armida	f
dorinda	f
marquerite	f
rubye	f
elisha	m
lavina	f
elizebeth	f
hosea	m
manual	m
wilber	m
roseanna	f
ellsworth	m
keneth	m
devorah	f
marnie	f
allegra	f
denzel	m
dania	f
brunilda	f
emi	f
giacomo	m
kenrick	m
fredy	m
abena	f
omayra	f
butch	m
mariann	f
tyra	f
christiane	f
germaine	f
ania	f
elly	f
ramel	m
yang	m
ishmael	m
milana	f
armand	m
tova	f
aleksey	m
kenan	m
xenia	f
ankit	m
nadya	f
tyesha	f
ashok	m
nanci	f
moira	f
rui	m
deon	m
patricio	m
shavonne	f
kumar	m
brock	m
sincere	m
amos	m
cooper	m
ulises	m
avinash	m
shayla	f
anja	f
yaakov	m
lucie	f
bette	f
nathaly	f
adil	m
lonnie	m
noam	m
paloma	f
carline	f
chani	f
viktoria	f
ori	m
leonor	f
vita	f
deepa	f
joon	m
benita	f
levar	m
scot	m
adonis	m
sammi	f
heidy	f
luann	f
burak	m
cleo	f
orville	m
alli	f
emerson	m
dinah	f
chance	m
nic	m
tanesha	f
yazmin	f
octavio	m
kamran	m
daquan	m
henri	m
lyndon	m
latanya	f
tai	m
sahil	m
arelis	f
jahaira	f
china	f
wang	m
barbra	f
jabari	m
geeta	f
alexey	m
scotty	m
latesha	f
sadia	f
ronen	m
anissa	f
gerri	f
yair	m
pattie	f
emely	f
sanford	m
stevie	m
sven	m
arjun	m
geneva	f
nadira	f
mavis	f
santo	m
godfrey	m
antwan	m
magnus	m
yumi	f
arman	m
deanne	f
heath	m
skip	m
vitaliy	m
christi	f
janay	f
letty	f
dev	m
hui	f
anu	f
leonid	m
dimitrios	m
jannette	f
atul	m
renzo	m
alyse	f
danette	f
christal	f
doc	m
vikki	f
zena	f
little	m
amira	f
nadege	f
delphine	f
nena	f
delano	m
romain	m
juli	f
nidia	f
silvio	m
salim	m
dulce	f
marino	m
ashraf	m
cate	f
giorgio	m
isiah	m
rogelio	m
meera	f
tomasz	m
milo	m
abu	m
dallas	m
tomoko	f
musa	m
danna	f
makeda	f
keenan	m
avraham	m
jung	m
maddie	f
shlomi	m
chan	m
manoj	m
jai	m
griffin	m
skyler	m
muhammed	m
tone	m
amine	m
yenny	f
guido	m
wendi	f
jules	m
sagar	m
davina	f
mert	m
cece	f
kwasi	m
ozzie	m
verna	f
zev	m
shruti	f
kevon	m
cindi	f
rosalba	f
zara	f
romina	f
rosaria	f
liat	f
billie	f
caesar	m
karine	f
gilda	f
cathie	f
rufus	m
odette	f
percy	m
lorie	f
vicente	m
norbert	m
tiffanie	f
irvin	m
kali	f
emir	m
can	m
hayden	m
myron	m
aaliyah	f
jeni	f
ellis	m
sung	m
krystina	f
theodora	f
kym	f
mikael	m
orly	f
linette	f
iesha	f
maximo	m
anastasiya	f
zoila	f
lilia	f
tawanna	f
mery	f
willis	m
praveen	m
zulma	f
asim	m
tamer	m
nyc	m
shalini	f
adriano	m
shara	f
joselyn	f
papa	m
evette	f
rajeev	m
tammi	f
norberto	m
bari	f
tae	m
jolie	f
donte	m
luba	f
hao	m
adel	m
benson	m
marques	m
waleska	f
chrystal	f
gautam	m
keyla	f
kareen	f
regine	f
justice	m
kiran	m
lisamarie	f
lenora	f
jasmina	f
bailey	f
giulio	m
giulia	f
pepe	m
zeynep	f
marielle	f
thiago	m
dorothea	f
akshay	m
raju	m
kirby	m
tarek	m
ariane	f
venice	f
lani	f
francisca	f
valencia	f
tamisha	f
shai	m
ricki	f
rossana	f
dayana	f
janae	f
kathi	f
youssef	m
ruslan	m
judie	f
katarina	f
cheyenne	f
anwar	m
fatimah	f
moussa	m
debbi	f
radhika	f
gisselle	f
hiram	m
arnaldo	m
alida	f
cyril	m
baris	m
akin	m
sahar	f
bonita	f
belle	f
meena	f
emile	m
hari	m
annalisa	f
frida	f
luiz	m
bing	m
ade	m
aleksandar	m
jackeline	f
yukiko	f
kaye	f
aryeh	m
hussein	m
tabatha	f
adelina	f
johanny	f
remi	m
karlene	f
khalilah	f
shanequa	f
luther	m
adriane	f
miguelina	f
darrel	m
patsy	f
brenna	f
yevgeniy	m
daren	m
akilah	f
sivan	f
malissa	f
timur	m
jacki	f
chao	m
lane	m
haris	m
nataliya	f
sarai	f
hallie	f
dimitry	m
leonora	f
shalom	m
shahid	m
malaika	f
serdar	m
hailey	f
kemi	f
rani	f
lucien	m
aracelis	f
ozzy	m
nita	f
arvind	m
dasha	f
malgorzata	f
johny	m
abbie	f
soo	f
romel	m
magali	f
shirin	f
kamila	f
santa	f
vitaly	m
shanika	f
katharina	f
ritchie	m
candida	f
dirk	m
baron	m
arif	m
ligia	f
augustine	m
isa	f
roma	f
nneka	f
roosevelt	m
eleonora	f
brennan	m
edie	f
tenisha	f
vivienne	f
yuval	m
leanna	f
rania	f
krishna	m
marlyn	f
elmer	m
yuka	f
marek	m
philipp	m
drake	m
maribeth	f
eugenio	m
waleed	m
dottie	f
antonette	f
umar	m
swati	f
suraj	m
mya	f
maxime	m
elton	m
karthik	m
lesly	f
suki	f
giovanny	m
gregorio	m
nasir	m
gerson	m
cinthia	f
valarie	f
sarita	f
kapil	m
anders	m
yury	m
sheetal	f
jean-paul	m
russel	m
shantell	f
menachem	m
leighton	m
consuelo	f
liane	f
reshma	f
cruz	m
loraine	f
maricela	f
paco	m
rahim	m
mandi	f
franziska	f
sinead	f
estrella	f
irfan	m
zhanna	f
nika	f
yun	f
sun	m
joi	f
juancarlos	m
josef	m
naoko	f
ewelina	f
mecca	f
shanti	f
darien	m
zenobia	f
dominik	m
sima	f
lew	m
ofer	m
jieun	f
stanislav	m
kiko	m
gian	m
suresh	m
chante	f
jina	f
rayna	f
sunshine	f
rivka	f
nidhi	f
zelda	f
salina	f
charley	m
amrita	f
seung	m
ezequiel	m
chastity	f
tamir	m
melodie	f
ramiro	m
junko	f
sindy	f
chanie	f
jarred	m
mackenzie	f
safiya	f
forrest	m
fiorella	f
rivky	f
violetta	f
hamza	m
dashawn	m
braulio	m
chang	m
christen	f
orit	f
dov	m
maki	f
cherisse	f
keron	m
dona	f
raoul	m
habib	m
elinor	f
virgil	m
benito	m
hillel	m
aly	f
abie	m
aliya	f
walt	m
leena	f
xin	m
evelina	f
gabi	f
jaleesa	f
taneisha	f
meri	f
selin	f
kellyann	f
kostas	m
freda	f
dovid	m
anisha	f
honey	f
enza	f
dian	f
john-paul	m
annika	f
mala	f
sylwia	f
wilmer	m
jhonny	m
elio	m
barrett	m
elmira	f
emogene	f
denna	f
ingeborg	f
gaynell	f
kathryne	f
hulda	f
zula	f
albertine	f
evelia	f
florene	f
lanita	f
myrtice	f
hedwig	f
eldora	f
adella	f
evalyn	f
delphia	f
felica	f
norene	f
jaunita	f
vernie	f
ocie	f
lorretta	f
adelia	f
enedina	f
lorinda	f
vicenta	f
lavada	f
elfriede	f
jeraldine	f
dorotha	f
debbra	f
mazie	f
almeda	f
ethelyn	f
lavinia	f
mozell	f
cythia	f
cleta	f
darcie	f
willene	f
christiana	f
leatha	f
bobbye	f
charolette	f
kandy	f
edelmira	f
joetta	f
corene	f
thersa	f
christene	f
alethea	f
syble	f
stephine	f
velva	f
velia	f
arcelia	f
fonda	f
tressie	f
kathlene	f
pinkie	f
georgetta	f
anglea	f
rufina	f
dorthea	f
nicolasa	f
kathyrn	f
machelle	f
jettie	f
altagracia	f
hai	m
oswaldo	m
loriann	f
niall	m
kendell	m
von	m
akira	m
mandeep	m
tamiko	f
nils	m
odessa	f
francia	f
anat	f
geovanny	m
benji	m
nikko	m
blaine	m
star	f
aiden	m
marquita	f
nikola	m
kwaku	m
fahad	m
che	m
lela	f
rima	f
deniz	m
demetra	f
estefania	f
barrington	m
blaise	m
kemar	m
tasia	f
ciro	m
rafal	m
filip	m
aki	f
carin	f
charisma	f
gianluca	m
jong	m
hiroko	f
blanche	f
pretty	f
marcelle	f
velma	f
aris	m
sha	f
jevon	m
miho	f
avril	f
jolene	f
asma	f
adela	f
qiana	f
rahsaan	m
wael	m
dakota	m
sherif	m
ani	f
ephraim	m
kerrie	f
jeanna	f
korey	m
corinna	f
shakima	f
ilir	m
inessa	f
yusef	m
evangeline	f
pinky	f
abdel	m
rabia	f
emanuele	m
fidel	m
goldie	f
chef	m
wai	m
rosetta	f
poonam	f
limor	f
gisella	f
dru	m
kip	m
eboni	f
alyce	f
anisa	f
francheska	f
katja	f
declan	m
maximilian	m
shereen	f
lesa	f
rosita	f
yaffa	f
janeth	f
brown	f
yuan	f
cheng	m
royce	m
andie	f
said	m
rickey	m
angella	f
simran	f
roselyn	f
sigrid	f
selene	f
danni	f
emmett	m
devi	f
suzanna	f
rikki	f
agron	m
alden	m
hyun	m
klara	f
chino	m
sneha	f
tawanda	f
volkan	m
adem	m
richelle	f
levent	m
shanique	f
wen	f
shakia	f
erez	m
cee	f
pranav	m
wyatt	m
petar	m
kerwin	m
heriberto	m
mordechai	m
nida	f
bogdan	m
walid	m
umair	m
tucker	m
ulysses	m
ronaldo	m
pankaj	m
zhi	m
mikki	f
shabana	f
blue	m
roe	f
aleks	m
laureen	f
stacia	f
ahsan	m
burton	m
venessa	f
miri	f
long	m
sarina	f
georges	m
elke	f
tolga	m
katrin	f
vee	f
patrycja	f
walker	m
kimani	m
carlito	m
tahir	m
marija	f
shanay	f
rawle	m
shanise	f
shan	m
crissy	f
ferdinand	m
nechama	f
bee	f
merle	f
tynisha	f
romy	f
ford	m
shin	m
harpreet	m
ping	f
zain	m
yessica	f
dorota	f
ren	m
diandra	f
yasin	m
fadi	m
isha	f
sharda	f
filomena	f
sherley	f
chasity	f
edwina	f
viktoriya	f
grisel	f
carolann	f
manu	m
matthieu	m
elda	f
bharat	m
saskia	f
yin	f
nikos	m
krzysztof	m
galit	f
cosmo	m
jens	m
man	m
brooks	m
ashwin	m
yolande	f
farida	f
catrina	f
harley	m
ammar	m
della	f
jessika	f
kennedy	m
catie	f
karol	f
nader	m
jimmie	m
vick	m
kadian	f
zane	m
devika	f
anne-marie	f
marleny	f
boaz	m
lowell	m
ernestine	f
u?ur	m
chintan	m
mohamad	m
ayman	m
haroon	m
johanne	f
dewayne	m
leeann	f
tiesha	f
asaf	m
izabela	f
alysha	f
neel	m
arben	m
melba	f
hamilton	m
franca	f
amelie	f
hye	f
ryo	m
carmella	f
nadeem	m
kacey	f
nicolle	f
nathalia	f
adeel	m
riki	f
liliya	f
jie	m
tushar	m
karissa	f
farid	m
virgilio	m
mitchel	m
alise	f
kirstin	f
monty	m
shelton	m
sofie	f
hernando	m
yoshi	m
norris	m
boo	m
august	m
beryl	f
kyoko	f
yashira	f
kiesha	f
farhana	f
bruna	f
suri	f
lise	f
syreeta	f
jeri	f
sharron	f
rhona	f
mayank	m
nickolas	m
hicham	m
lenin	m
jaison	m
antonino	m
quiana	f
leora	f
hardik	m
aneta	f
laure	f
olive	f
rabbi	m
flavio	m
peg	f
arvin	m
charise	f
angus	m
ayako	f
argenis	m
landon	m
holden	m
ant	m
puneet	m
zeke	m
norah	f
takashi	m
hamid	m
emad	m
genaro	m
lindy	f
ronit	f
cher	f
leilani	f
sacha	f
akiva	m
toyin	f
barak	m
emmanuelle	f
sinan	m
ameer	m
gray	m
kinga	f
chun	m
nefertiti	f
konrad	m
rock	m
kristofer	m
mathias	m
oral	m
piper	f
bina	f
sibel	f
erkan	m
julieann	f
shyam	m
tod	m
rashaun	m
yani	f
rubin	m
essence	f
ellyn	f
alphonso	m
carola	f
cinthya	f
kojo	m
esti	f
shivani	f
ginette	f
alona	f
nell	f
isaura	f
williams	m
eloise	f
sonali	f
hussain	m
kwabena	m
nishant	m
tameeka	f
yasmeen	f
erol	m
jarvis	m
liv	f
loredana	f
tianna	f
kabir	m
phill	m
sandrine	f
anurag	m
chandler	m
lavern	f
lizz	f
saif	m
ivanna	f
carson	m
fly	m
flo	f
arlette	f
griselda	f
lianna	f
aysha	f
ksenia	f
bin	m
saad	m
laszlo	m
zahid	m
hema	f
alesia	f
dudley	m
winsome	f
apple	f
addie	f
matilde	f
marlo	f
elad	m
alexandru	m
jah	m
vinod	m
mir	m
guo	m
dmitri	m
eneida	f
akua	f
tino	m
nikole	f
valentino	m
valentine	m
aleksander	m
jakob	m
sandhya	f
edson	m
jenice	f
haim	m
chung	m
naim	m
abbas	m
panos	m
kecia	f
nickie	f
sweet	f
miller	m
harlan	m
emeka	m
cristin	f
estela	f
darline	f
moon	f
lei	f
davin	m
zeeshan	m
green	m
valery	f
shayne	m
rupert	m
tita	f
nikia	f
payal	f
fitzroy	m
farhad	m
anson	m
zaid	m
carlotta	f
nona	f
peng	m
shamar	m
assaf	m
gaelle	f
siddharth	m
mihir	m
derwin	m
davida	f
bud	m
semih	m
zubair	m
rizwan	m
kseniya	f
janell	f
soledad	f
isabela	f
idris	m
lida	f
salomon	m
uriel	m
hollie	f
queenie	f
seymour	m
sapna	f
micky	m
margaux	f
kaylee	f
cal	m
imelda	f
merve	f
vidya	f
elisheva	f
aliyah	f
pradeep	m
ayelet	f
fabricio	m
christel	f
demi	f
ward	m
kaan	m
deep	m
nathanael	m
izabella	f
aditi	f
lisha	f
maude	f
ophelia	f
fabrice	m
rana	f
sage	m
anila	f
xander	m
sejal	f
tanner	m
jeniffer	f
shady	m
wilbert	m
kenisha	f
gennaro	m
andria	f
iwona	f
harmony	f
dorene	f
raffaele	m
ritu	f
kurtis	m
dimitris	m
tennille	f
aurelie	f
aurelia	f
garvin	m
nubia	f
miss	f
armin	m
kizzy	f
ramsey	m
sparkle	f
phylicia	f
natan	m
jaron	m
tyree	m
prakash	m
jones	m
genna	f
rosana	f
anthea	f
massimiliano	m
marley	m
elif	f
fabienne	f
sybil	f
zahra	f
berta	f
nailah	f
ioannis	m
augie	m
yaritza	f
vasilios	m
vandana	f
atiba	m
micaela	f
yitzy	m
clarice	f
sarit	f
amarilis	f
nikolai	m
alexei	m
atif	m
abbe	f
hany	m
maximus	m
geralyn	f
tyeisha	f
galen	m
goran	m
abhi	m
petal	f
jenise	f
geno	m
fara	f
shelly-ann	f
jamell	m
raffaella	f
yen	f
margherita	f
spike	m
reynold	m
cassandre	f
yasser	m
emiliano	m
roshni	f
mariella	f
gamal	m
evelin	f
carolin	f
danyelle	f
henrik	m
cash	m
gila	f
sheron	f
kemal	m
kamau	m
tzvi	m
shilpa	f
titus	m
lorrie	f
cristy	f
nadav	m
syeda	f
farzana	f
benoit	m
cristine	f
dede	f
naquan	m
lino	m
nada	f
faraz	m
bishop	m
piero	m
denver	m
shanae	f
lexie	f
danica	f
sheniqua	f
chetan	m
won	m
rasheeda	f
vladislav	m
reuven	m
tana	f
pink	f
jair	m
dereck	m
corrie	f
renita	f
huseyin	m
satish	m
tarsha	f
shomari	m
shaniece	f
vishnu	m
ena	f
kam	m
jakub	m
vashti	f
judah	m
bernadine	f
tyisha	f
nasser	m
doron	m
jimi	m
kartik	m
yohan	m
mitesh	m
biana	f
natalee	f
bender	m
carine	f
iva	f
mirian	f
aggie	f
thor	m
ebru	f
gilad	m
takeshi	m
khan	m
dalton	m
janessa	f
marilou	f
lita	f
cisco	m
maha	f
ziggy	m
rhiannon	f
win	m
hudson	m
guilherme	m
maren	f
kristyn	f
tammie	f
petey	m
sanja	f
frieda	f
tashi	m
una	f
addy	f
shaka	m
samanta	f
shon	m
feng	m
alberta	f
kosta	m
gal	m
kerryann	f
kenyetta	f
raffi	m
mariama	f
marika	f
abhinav	m
yann	m
andrae	m
dorit	f
judd	m
pop	m
kamel	m
letisha	f
willa	f
lillie	f
fabien	m
maryjane	f
mordy	m
alphonse	m
hindy	f
tunde	m
iryna	f
vanesa	f
nirav	m
sai	f
hasani	m
charly	m
federica	f
arkady	m
keely	f
viviane	f
maksim	m
yahya	m
sharice	f
bebe	f
idalia	f
kana	f
evens	m
iman	f
albina	f
kory	m
brook	f
shawana	f
ernst	m
faruk	m
felecia	f
lianne	f
abi	f
levon	m
mickael	m
quintin	m
idan	m
homer	m
ran	m
petrina	f
terrie	f
spiros	m
didier	m
roxann	f
galo	m
johannes	m
antonietta	f
taurean	m
kiera	f
patrik	m
terese	f
noriko	f
irv	m
zuleika	f
bracha	f
olesya	f
despina	f
thais	f
damir	m
marcellus	m
diedre	f
eri	f
christin	f
ayisha	f
noe	m
taniqua	f
rino	m
jeana	f
minna	f
arianne	f
anas	m
sherice	f
marcio	m
blythe	f
anoop	m
tyshawn	m
dominika	f
peterson	m
alessio	m
louann	f
miryam	f
scarlet	f
carli	f
dixie	f
yara	f
ay?e	f
fatou	f
chico	m
sruly	m
selwyn	m
celso	m
jasen	m
tanvir	m
amal	f
shiri	f
yannick	m
junaid	m
suzi	f
collette	f
silver	m
nerissa	f
saida	f
guadalupe	f
cengiz	m
mohsin	m
nitza	f
andreea	f
sanjeev	m
fitz	m
satoshi	m
sandee	f
lorri	f
aram	m
tarun	m
sonam	f
lauryn	f
maeve	f
arik	m
arie	m
prudence	f
randell	m
halima	f
candi	f
tommaso	m
jaquan	m
alok	m
joie	f
fady	m
kamilah	f
arline	f
boss	m
reema	f
demetrios	m
brigette	f
yunus	m
daysi	f
leann	f
margery	f
hadley	f
chyna	f
francoise	f
patrizia	f
keegan	m
zoya	f
demetria	f
aziza	f
pieter	m
lyssa	f
regis	m
vania	f
terra	f
kerstin	f
esra	f
natali	f
emanuela	f
kassandra	f
neeraj	m
cristiano	m
merav	f
jessa	f
neta	f
ketan	m
cesare	m
bunny	f
jinny	f
nadja	f
kern	m
chioma	f
ralphie	m
stanford	m
malka	f
alesha	f
orin	m
yao	m
jawad	m
zenaida	f
uzma	f
sugar	f
arsenio	m
ayo	m
teresita	f
casandra	f
alper	m
miz	f
aramis	m
giuliana	f
melany	f
arslan	m
pratik	m
horacio	m
marwan	m
andrzej	m
puja	f
bessie	f
brenden	m
riaz	m
niraj	m
hansel	m
deneen	f
graeme	m
vik	m
leron	m
aiesha	f
ilse	f
elodie	f
asya	f
rahmel	m
tracee	f
racheal	f
shareen	f
mariusz	m
sharona	f
garrick	m
lakia	f
liang	m
linus	m
malia	f
chadwick	m
amadou	m
neftali	m
joycelyn	f
yusuke	m
tye	m
latosha	f
chika	f
berenice	f
roshan	m
ralphy	m
papi	m
sallie	f
yonatan	m
patryk	m
julisa	f
janee	f
enoch	m
santana	f
sharmaine	f
shazia	f
rah	m
jenine	f
donal	m
vivi	f
rondell	m
niesha	f
cassidy	f
trevon	m
rik	m
rachele	f
kayleen	f
trudie	f
isidra	f
magaret	f
noma	f
naoma	f
kimbery	f
drema	f
shirleen	f
margorie	f
kasie	f
barbar	f
pearlene	f
pauletta	f
jadwiga	f
deeann	f
iluminada	f
dannette	f
loree	f
hermina	f
leonore	f
luise	f
tereasa	f
dorathy	f
tennie	f
versie	f
georgine	f
mozella	f
patience	f
margaretta	f
lynelle	f
cecila	f
lovella	f
clarine	f
willette	f
hildred	f
tuyet	f
assunta	f
alline	f
collen	f
maybell	f
arnita	f
irmgard	f
estell	f
loma	f
waltraud	f
babara	f
cordie	f
thresa	f
earlean	f
ardella	f
glendora	f
florance	f
tanna	f
else	f
regenia	f
hilde	f
clemmie	f
joye	f
annett	f
ozella	f
augustina	f
barbera	f
rozella	f
macie	f
ethyl	f
branda	f
ethelene	f
vallie	f
terresa	f
georgene	f
arlena	f
drusilla	f
sudie	f
lera	f
pearle	f
armanda	f
regena	f
freeda	f
remedios	f
tonda	f
billye	f
erlene	f
gertrud	f
delpha	f
leonila	f
lavonia	f
floretta	f
hilaria	f
tequila	f
kathern	f
altha	f
verdie	f
veta	f
enola	f
theola	f
jesusa	f
ilda	f
trula	f
gaylene	f
ludie	f
bernetta	f
ardell	f
myrtie	f
lashunda	f
rosamond	f
almeta	f
delena	f
debroah	f
louvenia	f
sharyl	f
kazuko	f
dreama	f
margurite	f
margarite	f
vernetta	f
yolando	f
gearldine	f
adaline	f
rosia	f
verlie	f
kaylene	f
cleora	f
hyon	f
faustina	f
margarett	f
emelda	f
gwenda	f
elizbeth	f
nickole	f
margart	f
erminia	f
elois	f
delta	f
myrle	f
echo	f
shela	f
pamelia	f
elanor	f
kathaleen	f
inocencia	f
odilia	f
exie	f
elodia	f
verdell	f
arnetta	f
slyvia	f
mammie	f
veola	f
librada	f
angele	f
earleen	f
loyce	f
willia	f
alvera	f
melissia	f
marget	f
particia	f
lavera	f
annice	f
annabell	f
janetta	f
kathey	f
beverlee	f
arletta	f
margeret	f
criselda	f
cathey	f
ermelinda	f
shelba	f
carmon	f
jacquelyne	f
doloris	f
vena	f
glady	f
glynda	f
neoma	f
reatha	f
junita	f
kimberlie	f
luvenia	f
arvilla	f
rochell	f
laverna	f
magdalen	f
gertha	f
rebbecca	f
retta	f
ignacia	f
fredia	f
epifania	f
inell	f
ammie	f
valda	f
berneice	f
verlene	f
avelina	f
holley	f
daphine	f
shery	f
grzegorz	m
davy	m
palma	f
didi	f
himanshu	m
sekou	m
ahuva	f
divine	m
lenka	f
kumiko	f
amado	m
mireya	f
baba	m
ruchi	f
manon	f
jad	m
marita	f
bri	f
eren	m
younes	m
dimitra	f
omri	m
azra	f
zakiya	f
nguyen	f
sherine	f
kyung	m
ama	f
mayur	m
leandra	f
felicita	f
madelin	f
megumi	f
naeem	m
fannie	f
vittorio	m
marin	f
lennie	m
zoran	m
tejas	m
steffen	m
waqas	m
nando	m
charleen	f
mandisa	f
taha	m
evonne	f
serene	f
umberto	m
sparky	m
alexandros	m
demetri	m
tomo	m
sveta	f
trenton	m
philippa	f
wilton	m
shanda	f
alondra	f
darnel	m
kami	f
adalberto	m
bojan	m
yousef	m
paddy	m
denisha	f
ceci	f
seeta	f
jennine	f
keston	m
ioana	f
bess	f
jaimee	f
kendrick	m
merlin	m
teena	f
shannel	f
costa	m
faheem	m
amish	m
sajid	m
osiris	m
yoav	m
seb	m
leor	m
simo	m
wilkins	m
zheng	m
mostafa	m
nnamdi	m
domenica	f
colm	m
hyung	m
cortney	f
henny	f
tevin	m
estee	f
danika	f
yetunde	f
kaity	f
sho	m
luc	m
neo	m
drea	f
jenniffer	f
mahmud	m
kazi	m
arti	f
samy	m
amrit	m
armen	m
pamella	f
raysa	f
ambrose	m
gianfranco	m
napoleon	m
yasir	m
coreen	f
yanky	m
chanda	f
mohan	m
maame	f
maricel	f
virginie	f
marisela	f
nazmul	m
domonique	f
brice	m
iraida	f
lawanda	f
kanika	f
jameson	m
nazia	f
fei	m
atiya	f
bekim	m
neda	f
elva	f
lilliam	f
elma	f
yogesh	m
tory	m
yomaira	f
joselito	m
bria	f
jacinta	f
krystyna	f
aixa	f
isaias	m
gurpreet	m
efren	m
saira	f
stavros	m
sanela	f
naresh	m
manisha	f
karima	f
warner	m
regan	m
sohail	m
vidal	m
michiko	f
natisha	f
caro	f
renae	f
mitzi	f
jaspreet	m
ruthy	f
sharad	m
sharonda	f
gennady	m
macy	f
ramin	m
minji	f
alicja	f
dwain	m
burhan	m
attila	m
rachid	m
petr	m
mukesh	m
jerald	m
birgit	f
nikolaos	m
raman	m
mad	m
lyudmila	f
steffi	f
doni	m
sultan	m
keven	m
daron	m
anette	f
karishma	f
toi	f
mirta	f
mylene	f
jyoti	f
shweta	f
bertrand	m
rigoberto	m
barb	f
luana	f
femi	m
panagiotis	m
jean-pierre	m
ola	f
loreta	f
amandeep	m
shelia	f
ilaria	f
davey	m
kobi	m
aurea	f
bridgett	f
maggy	f
brenton	m
desi	f
tesha	f
annabel	f
amna	f
aurelio	m
buck	m
danisha	f
alfie	m
mireille	f
betsey	f
jalisa	f
raghav	m
breanne	f
liu	m
zainab	f
jazzy	f
ramses	m
dragan	m
oguz	m
dieter	m
ariela	f
moran	f
hashim	m
michaelle	f
helga	f
tatjana	f
lyndsay	f
yohanna	f
khurram	m
tuan	m
kirsty	f
zoey	f
georgiana	f
vaibhav	m
tyquan	m
kerem	m
bobble	m
glory	f
kei	m
waseem	m
felisha	f
shawanna	f
ambar	f
tosha	f
shaquille	m
mirko	m
rehana	f
gabor	m
mikaela	f
rie	f
helaine	f
dejan	m
tad	m
silas	m
yoon	f
haywood	m
fawn	f
mairead	f
saeed	m
kfir	m
dusty	m
shakeema	f
shahzad	m
leia	f
leif	m
amparo	f
mendel	m
rajendra	m
niklas	m
erlinda	f
gregor	m
iain	m
latonia	f
linnea	f
ananda	f
marti	f
yoram	m
issac	m
cornell	m
hellen	f
kenichi	m
shaquanna	f
ardian	m
neeta	f
shantae	f
kaleb	m
munir	m
felicity	f
ajit	m
rajan	m
gabriele	m
pavan	m
reese	m
madina	f
ido	m
lizabeth	f
alessia	f
beto	m
maor	m
ginamarie	f
ramone	m
etienne	m
avigail	f
nordia	f
grayson	m
archana	f
quinton	m
kwadwo	m
fahim	m
ozan	m
dacia	f
nadir	m
jazz	m
azeem	m
hila	f
asako	f
storm	m
reba	f
patel	m
angelita	f
sallyann	f
sumeet	m
ciaran	m
katalin	f
deshaun	m
ehab	m
sharita	f
meng	m
madonna	f
uma	f
genie	f
lupita	f
makiko	f
radames	m
simi	f
tiago	m
mehul	m
ale	m
abid	m
stefany	f
oskar	m
tijuana	f
peyton	m
jaya	f
sonal	f
bronwyn	f
saleem	m
mansoor	m
collins	m
lateef	m
mellissa	f
shu	m
arnel	m
keysha	f
talisa	f
fredrik	m
golda	f
mahmut	m
marianela	f
sapphire	f
olympia	f
deandra	f
mirza	m
cristhian	m
agatha	f
harsh	m
meridith	f
addison	m
pierce	m
abdoulaye	m
danya	f
elisabetta	f
mista	m
sammie	m
judit	f
shamir	m
ayla	f
fitzgerald	m
myrtle	f
bertram	m
leonie	f
kyaw	m
deja	f
efe	m
juju	f
amjad	m
ambika	f
ousmane	m
bronx	m
sylvain	m
misael	m
priti	f
dixon	m
sania	f
coby	m
jaqueline	f
ketty	f
dark	m
papo	m
denzil	m
jameel	m
brit	f
brie	f
jet	m
jeb	m
rain	f
kady	f
filipe	m
eman	f
maximiliano	m
richmond	m
gilles	m
dyan	f
qasim	m
cedrick	m
sita	f
osei	m
hiromi	f
hedy	f
micki	f
laron	m
carlyle	m
rasheem	m
nabeel	m
stevens	m
roxie	f
damali	f
keon	m
tobi	f
kima	f
carlina	f
ashlie	f
stef	f
shakina	f
michelangelo	m
aretha	f
vida	f
lilliana	f
casper	m
sigal	f
heshy	m
manolo	m
tashana	f
cintia	f
orion	m
mar	f
chava	f
rajib	m
shelli	f
adena	f
dae	m
kathrin	f
fang	f
nancie	f
song	m
socrates	m
avalon	f
bhavin	m
midori	f
hyacinth	f
jace	m
christelle	f
london	m
tiziana	f
ela	f
tera	f
joannie	f
sera	f
shantelle	f
faina	f
eder	m
bashir	m
juliane	f
georgie	m
washington	m
arsen	m
melyssa	f
devan	f
darian	m
timo	m
michaelangelo	m
damla	f
isamar	f
mica	f
major	m
osama	m
phuong	f
kaori	f
afiya	f
salih	m
shaunte	f
reiko	f
kang	m
herve	m
dawne	f
shanel	f
thao	f
aamir	m
sascha	m
susy	f
trinity	f
cathryn	f
damani	m
reem	f
malin	f
sander	m
kellee	f
achilles	m
emrah	m
lainie	f
kishore	m
nya	f
avani	f
marv	m
parag	m
lystra	f
maayan	f
donato	m
jocelyne	f
seon	m
ivory	f
edgard	m
akbar	m
neisha	f
free	m
marwa	f
viva	f
tin	m
phoenix	m
merrill	f
georgi	m
teisha	f
sonu	m
khris	m
sharese	f
rio	m
metin	m
yokasta	f
cleopatra	f
cait	f
orna	f
graig	m
ashly	f
rayon	m
liron	f
srinivas	m
jiyoung	f
bianka	f
shireen	f
burcu	f
marzena	f
marly	f
mayer	m
kandice	f
rossy	f
norm	m
noman	m
nikolay	m
cleon	m
topher	m
opal	f
sherise	f
belen	f
aarti	f
terell	m
tameika	f
araceli	f
mazen	m
bora	m
kameron	m
arkadiy	m
kenyatta	m
bigg	m
gaston	m
damiano	m
americo	m
renaldo	m
mirela	f
sixto	m
shantal	f
leonidas	m
cathi	f
sharisse	f
antionette	f
merri	f
gita	f
cenk	m
stas	m
ulrich	m
jackee	f
sanna	f
evgeny	m
maher	m
romana	f
sead	m
halil	m
cordell	m
laine	f
derron	m
yocasta	f
benedetta	f
jarret	m
tibor	m
qian	f
que	m
marcell	m
lanny	m
rimma	f
hung	m
marya	f
marios	m
deirdra	f
gay	f
prem	m
malinda	f
yamil	m
dory	f
rachna	f
deyanira	f
dionisio	m
hamish	m
edina	f
henrique	m
marquise	m
rudolf	m
son	m
mahendra	m
tierra	f
job	m
joo	f
alexi	m
caryl	f
lateisha	f
danish	m
deserie	f
sakina	f
nessa	f
usha	f
rashaan	m
reyes	m
bryon	m
filiz	f
fior	f
catharine	f
zita	f
lamin	m
linh	f
stephania	f
sangeeta	f
jemal	m
greer	f
zee	m
takako	f
raizy	f
anant	m
hala	f
fatoumata	f
engin	m
adelaida	f
jigar	m
hiro	m
nery	f
mili	f
donatella	f
nini	f
xiang	m
orhan	m
kary	f
shae	f
iqbal	m
juliann	f
aria	f
kamilla	f
bev	f
danita	f
moya	f
dennise	f
herbie	m
jiwon	f
pebbles	f
laquan	m
wojciech	m
ruddy	m
arlyn	f
dayne	m
brando	m
deron	m
stacey-ann	f
jacopo	m
alonso	m
mayumi	f
camelia	f
itamar	m
serina	f
ayhan	m
buster	m
stanton	m
iggy	m
deepika	f
sherelle	f
amol	m
lateefah	f
brigida	f
loreen	f
javed	m
yanina	f
islam	m
micheline	f
reda	m
cierra	f
tanaya	f
venecia	f
jolanta	f
tamas	m
kalina	f
carolyne	f
melaine	f
cami	f
elicia	f
keyur	m
mahdi	m
ivo	m
kola	m
catarina	f
jes	f
jee	f
caron	f
kassie	f
lucio	m
tre	m
saba	f
clarisse	f
artan	m
emelia	f
rosaura	f
anam	f
rasheen	m
dilcia	f
coral	f
babatunde	m
tavia	f
quan	m
moni	f
abdoul	m
lon	m
foster	m
ife	f
malky	f
savitri	f
gosia	f
nabila	f
basem	m
admir	m
yaw	m
natoya	f
akim	m
velvet	f
davidson	m
murtaza	m
vineet	m
kendel	m
edyta	f
tenesha	f
shalonda	f
monet	f
smiley	f
rosalee	f
latrice	f
aoife	f
furkan	m
donn	m
nola	f
saima	f
elayne	f
reva	f
frederica	f
stalin	m
kleber	m
rajat	m
jaci	f
philomena	f
cinzia	f
ely	m
sumon	m
cool	m
dorie	f
lucius	m
rosalina	f
shawanda	f
qing	f
elida	f
randee	f
smita	f
rian	m
dahiana	f
dimple	f
kaya	f
olu	m
lauretta	f
eloy	m
kaydian	f
rochel	f
evita	f
san	m
yasemin	f
ita	f
jamelia	f
sherrell	f
lancelot	m
yash	m
miroslav	m
ikey	m
monae	f
darell	m
kourtney	f
laetitia	f
lan	f
maximillian	m
cristobal	m
blerim	m
anamaria	f
samer	m
jourdan	m
abiola	f
celestina	f
kane	m
thad	m
lelia	f
saverio	m
daphnee	f
sundeep	m
misa	f
philly	m
roza	f
kwan	m
jacek	m
jihye	f
neill	m
nichola	f
ebonie	f
alyona	f
hemant	m
chin	m
chavi	f
cali	f
aharon	m
shanette	f
jalissa	f
anatoliy	m
andreina	f
dash	m
digna	f
maryse	f
mattia	m
kermit	m
mor	m
jerrell	m
kasandra	f
jael	f
yanique	f
nuria	f
rayshawn	m
sheba	f
elin	f
efraim	m
tish	f
leopold	m
dimas	m
sherese	f
naman	m
edita	f
matan	m
alistair	m
javan	m
nickesha	f
koray	m
branko	m
olya	f
hina	f
rhys	m
brittani	f
soni	f
fan	m
marisel	f
etan	m
ara	m
anni	f
tan	m
tao	m
kezia	f
dariusz	m
york	m
renny	m
anup	m
richa	f
kalvin	m
thompson	m
yevgeniya	f
chitra	f
zion	m
karrie	f
divina	f
scottie	m
yogi	m
alban	m
jiang	m
carley	f
abhilash	m
konstantinos	m
sadaf	f
safet	m
zsolt	m
tremayne	m
lakesha	f
mitzie	f
serita	f
chrissie	f
inger	f
jerson	m
hulya	f
ekta	f
nicoletta	f
danae	f
elvia	f
neetu	f
ohad	m
garret	m
darshan	m
jovita	f
verena	f
lazaro	m
marat	m
ilhan	m
hiren	m
gissell	f
brittny	f
omaira	f
espezy	m
sultana	f
mustapha	m
cicely	f
parth	m
ilyas	m
narayan	m
erinn	f
rashmi	f
aston	m
anis	m
umut	m
maryrose	f
kristel	f
basia	f
shankar	m
juliya	f
itai	m
murphy	m
honor	f
piyush	m
tahisha	f
akhil	m
hamlet	m
constantin	m
armani	m
emory	m
ayumi	f
geraldo	m
igal	m
batsheva	f
devra	f
raghu	m
anda	f
roscoe	m
nadim	m
alp	m
brien	m
dalila	f
gopal	m
girish	m
gill	m
rayan	m
nikolas	m
loni	f
kamar	m
aylin	f
windy	f
krysta	f
gleb	m
deven	m
nayda	f
franny	f
crista	f
aminata	f
pravin	m
kerron	m
ziad	m
melony	f
cielo	f
mena	f
tareq	m
jamison	m
cammy	f
betzaida	f
eamon	m
kahlil	m
aqeel	m
magalie	f
rosaline	f
keyon	m
moti	m
jeffry	m
maida	f
lamia	f
santi	m
jonna	f
ludmila	f
stephenie	f
issa	m
chantell	f
weston	m
piera	f
quana	f
rolanda	f
jerri	f
live	m
nikisha	f
kika	f
willard	m
latifa	f
gezim	m
ankita	f
candido	m
vern	m
umesh	m
malini	f
nunzio	m
juice	m
woo	m
shad	m
aric	m
mariluz	f
kamille	f
shi	m
lashanna	f
waldo	m
milica	f
aparna	f
myke	m
kalyan	m
dilip	m
shiv	m
nekeisha	f
darya	f
leopoldo	m
deandre	m
rada	f
jovanna	f
klaus	m
del	m
den	m
chiaki	f
hermes	m
nacho	m
rea	f
reg	m
lilibeth	f
keturah	f
carlitos	m
street	m
sanya	f
abdiel	m
marjory	f
amoy	f
meyer	m
brandie	f
eladio	m
marilynn	f
odetta	f
cortez	m
TRUE	m
netta	f
lorin	f
werner	m
allister	m
jacinda	f
kimara	f
tea	f
komal	f
kerrin	f
nastassia	f
lysette	f
suman	m
sheng	m
zahir	m
kervin	m
nyesha	f
atef	m
mirtha	f
phaedra	f
elmo	m
nova	f
mima	f
lissy	f
rosina	f
jeong	f
dannielle	f
kelly-ann	f
fermin	m
jameela	f
malvin	m
eryn	f
toni-ann	f
dawnmarie	f
estefany	f
katey	f
modesto	m
caprice	f
kayode	m
jingjing	f
ajith	m
edmundo	m
alysa	f
rosette	f
towana	f
kera	f
merrie	f
diogenes	m
adanna	f
barrie	f
jensen	m
zakiyyah	f
kaz	m
charline	f
katherina	f
zafer	m
corie	f
kayleigh	f
sharleen	f
yosi	m
valbona	f
trudi	f
page	f
zehra	f
johnpaul	m
dot	f
dimitar	m
rainer	m
veda	f
ora	f
roseline	f
mateusz	m
odalys	f
terryann	f
yanet	f
durrell	m
narendra	m
lakshmi	f
jayden	m
wagner	m
liliane	f
kait	f
melani	f
zakia	f
harlem	m
urban	m
bethann	f
pasha	m
keli	f
julieta	f
bambi	f
nirmala	f
luiza	f
darron	m
iam	m
supa	m
tiger	m
minister	m
sully	f
lysa	f
benjie	m
savita	f
bubba	m
rinat	f
eda	f
edi	m
edo	m
akwasi	m
siu	m
sia	f
july	f
vonetta	f
amer	m
emilee	f
mischa	f
danelle	f
jahmel	m
riad	m
ryoko	f
ebenezer	m
esty	f
deedee	f
shannan	f
oli	m
vernell	f
dhruv	m
mesha	f
viki	f
karoline	f
noor	m
taras	m
monifa	f
oumar	m
analia	f
fleur	f
vlada	f
donnette	f
lashanda	f
aakash	m
koby	m
tsering	m
ernestina	f
cherelle	f
loyda	f
ritz	f
onika	f
akane	f
besnik	m
leonela	f
atsuko	f
rubina	f
nusrat	f
eloisa	f
zia	m
lolita	f
shasha	f
eti	f
bassam	m
maegan	f
mohd	m
dragana	f
ivor	m
lam	m
liran	m
vikash	m
lula	f
cici	f
zaheer	m
ill	m
nii	m
meghann	f
sameh	m
donell	m
corrado	m
jamey	m
jemma	f
jalil	m
calogero	m
natividad	f
anca	f
madhu	m
dashaun	m
lis	f
sheik	m
imad	m
luanne	f
kori	f
varsha	f
salah	m
marylin	f
britta	f
dritan	m
mirjana	f
naimah	f
hesham	m
andra	f
shonna	f
shanaya	f
lakiesha	f
vanita	f
bola	f
berk	m
florencia	f
france	f
mellisa	f
muna	f
shaunda	f
prasad	m
imtiaz	m
hattie	f
kathyann	f
keira	f
genny	f
finn	m
giana	f
shenelle	f
hanson	m
blaze	m
sharifa	f
pernell	m
bear	m
natascha	f
amita	f
roya	f
ras	m
nadeen	f
cecilio	m
vesna	f
toshi	m
yale	m
naama	f
altaf	m
levy	m
arzu	f
jomo	m
kenn	m
costas	m
white	m
sofiya	f
glenys	f
mourad	m
karsten	m
mirsad	m
lacy	f
sona	f
demir	m
fancy	f
artemis	f
conroy	m
kash	m
yudelka	f
karma	m
durell	m
agus	m
taj	m
bentley	m
nannette	f
yechiel	m
bastien	m
glenny	f
uriah	m
zarina	f
leela	f
zalman	m
majid	m
vipin	m
minal	f
macho	m
cassy	f
chelle	f
rehan	m
zuzana	f
jean-luc	m
santosh	m
corine	f
sebastiano	m
ugo	m
tres	m
pema	f
janusz	m
salima	f
riva	f
etta	f
jean-louis	m
saleh	m
eytan	m
zhou	m
shakir	m
shakil	m
shakim	m
naisha	f
dequan	m
aung	m
dorcas	f
miya	f
devaughn	m
talya	f
gui	m
kedar	m
sharee	f
giles	m
jarell	m
krystian	m
mocha	f
keara	f
dmytro	m
darcel	f
ainsley	m
shantay	f
masako	f
benjy	m
merry	f
albana	f
keke	f
yola	f
bledar	m
orson	m
naveed	m
bibiana	f
bayo	m
latifah	f
shakema	f
darleen	f
telly	m
avion	f
tashia	f
janise	f
liberty	f
maryana	f
monisha	f
royal	m
evangelia	f
yanick	f
nyree	f
yisroel	m
leda	f
queens	m
gen	m
willem	m
arash	m
norka	f
jasmyn	f
nakisha	f
kamala	f
oshane	m
makeba	f
tamesha	f
monie	f
cho	m
hiroshi	m
shonda	f
leland	m
aisling	f
theron	m
shenika	f
adekunle	m
shaunna	f
rosangela	f
anatoly	m
kimmie	f
rasheda	f
shonette	f
kenyon	m
merlyn	f
shifra	f
voula	f
jerilyn	f
braden	m
nilesh	m
buddha	m
sharmila	f
tarra	f
kevyn	m
okan	m
tati	f
segun	m
narcisa	f
safraz	m
valeriya	f
yefim	m
anshul	m
chichi	f
edin	m
carleen	f
shahida	f
charlton	m
truman	m
nelida	f
faiz	m
naoki	m
fox	m
melania	f
avner	m
manal	f
marline	f
shaul	m
herby	m
candie	f
rashaad	m
rodriguez	m
tinamarie	f
naeemah	f
yumiko	f
biagio	m
merideth	f
shinya	m
macarena	f
travon	m
donavan	m
lavon	m
amilcar	m
maud	f
danuta	f
indiana	f
zen	m
gavriel	m
eamonn	m
tha	m
rahman	m
radha	f
cherish	f
yanni	m
yanna	f
jony	m
melonie	f
zhang	f
revital	f
carroll	f
amani	f
real	m
sherly	f
mamie	f
henning	m
kelechi	m
salem	m
frederik	m
laquana	f
neelam	f
mazal	f
clarke	m
dwaine	m
lauralee	f
pui	f
sheikh	m
elder	m
buzz	m
lucretia	f
natasa	f
daiana	f
hezekiah	m
tafari	m
jacque	f
ece	f
hadi	m
adham	m
stevenson	m
kathia	f
maury	m
karolyn	f
fredric	m
krystel	f
raymon	m
kerin	f
luci	f
yohanny	f
jenee	f
bakari	m
koko	f
shiho	f
emmie	f
bushra	f
akihiro	m
inbal	f
verona	f
rupa	f
radu	m
karmen	f
jovanny	m
barri	f
zuleyka	f
taniesha	f
beena	f
kushtrim	m
kacie	f
kadir	m
trixie	f
jannine	f
jeimy	f
damone	m
jesica	f
narda	f
pei	f
martinez	m
mariuxi	f
jennette	f
ildiko	f
vipul	m
rei	f
hazem	m
wolfgang	m
meka	f
deepti	f
zaira	f
elbert	m
babette	f
nur	f
tressa	f
campbell	m
shamim	m
tessie	f
cinnamon	f
romona	f
clover	f
polo	m
mansi	f
garnet	m
salome	f
alane	f
tedd	m
valerio	m
nasrin	f
marlin	f
enmanuel	m
baruch	m
cam	m
sohel	m
emerald	f
rigo	m
mehreen	f
jemima	f
anju	f
zvi	m
hanan	f
roddy	m
hamad	m
gbenga	m
ghislaine	f
yasmina	f
niccole	f
symone	f
uday	m
desire	f
jignesh	m
gamze	f
niasia	f
mely	f
corbin	m
namrata	f
betina	f
alley	f
sujin	f
kerby	m
lissett	f
vasiliki	f
vielka	f
lilla	f
louella	f
evi	f
jolanda	f
marilu	f
cristiana	f
rekha	f
sujan	m
heike	f
sakinah	f
florina	f
westley	m
sabrena	f
darla	f
wah	m
willow	f
january	f
melly	f
drita	f
madelaine	f
rubi	f
miracle	f
asli	f
carlin	m
nani	f
catrice	f
zeina	f
galia	f
kan	m
kal	m
jodi-ann	f
emmanuella	f
sheilah	f
swetha	f
prateek	m
cyn	f
ciera	f
kamisha	f
marianella	f
maisha	f
padma	f
aydin	m
lyubov	f
kiel	m
kayan	f
dudu	m
kristan	f
lucian	m
leydi	f
adeola	f
zaki	m
wilda	f
lashonda	f
merryl	f
morty	m
mary-jane	f
cosimo	m
talha	m
jean-michel	m
amaris	f
justo	m
miyuki	f
sabin	m
shanikqua	f
anitra	f
harun	m
geovanni	m
antonis	m
nimrod	m
pepper	f
gidget	f
anusha	f
yuna	f
tremaine	m
lekan	m
viv	f
natasia	f
beckie	f
eliseo	m
devendra	m
nami	f
shaneka	f
tonisha	f
mihaela	f
rosi	f
supriya	f
naila	f
budi	m
abir	m
talisha	f
shade	f
javi	m
andriy	m
ayodele	m
genise	f
shaquan	m
yomi	m
sim	m
oneal	m
shell	f
petros	m
asuka	f
cletus	m
isadora	f
pallavi	f
heide	f
jihan	f
umit	m
angelic	f
esta	f
carmelita	f
ole	m
lucila	f
zana	f
freya	f
gibran	m
pratima	f
blas	m
saiful	m
tarah	f
ravindra	m
rasha	f
zeus	m
minh	m
yelitza	f
xing	m
shun	m
amandine	f
emiko	f
ofelia	f
maggi	f
mathilde	f
kamaria	f
meltem	f
yejin	f
aryan	m
urszula	f
pinar	f
selim	m
shareef	m
mayu	f
celestine	f
meiling	f
shanea	f
fletcher	m
gardy	m
aviad	m
susi	f
rama	m
earle	m
punit	m
synthia	f
toney	m
batya	f
giorgia	f
leslye	f
linden	m
rudi	m
thai	m
takuya	m
brayan	m
breanna	f
arshad	m
amara	f
yira	f
letizia	f
gwyneth	f
dorothee	f
sudhir	m
kellen	m
mindi	f
lashon	f
shenequa	f
alycia	f
eon	m
dorina	f
evangelos	m
ravin	m
jerel	m
bar	m
volodymyr	m
bam	m
gustav	m
din	m
peri	f
clair	f
coretta	f
thanh	m
nettie	f
jenel	f
channel	f
fouad	m
paresh	m
aby	m
novella	f
duwayne	m
ryu	m
lesia	f
brynn	f
mikel	m
josefa	f
uche	m
moriah	f
erhan	m
miosotis	f
biggie	m
germain	m
waldemar	m
sing	m
sina	m
cihan	m
enes	m
marlen	f
oriana	f
udi	m
sweta	f
janey	f
oana	f
alka	f
sherika	f
marinela	f
lilith	f
adebayo	m
diann	f
karel	m
klaudia	f
preya	f
cathrine	f
chevonne	f
laquanda	f
ashutosh	m
roody	m
sudesh	m
katiana	f
megha	f
brandee	f
berto	m
loida	f
rip	m
leisa	f
aiko	f
javid	m
tam	f
chanell	f
tran	f
ludovic	m
kanako	f
ornella	f
shera	f
kaushal	m
cherrie	f
ching	f
seda	f
shreya	f
arron	m
shayan	m
linnette	f
ferhat	m
kiya	f
niya	f
davi	m
lashaun	f
kamini	f
rishabh	m
rolf	m
selcuk	m
krystin	f
glynis	f
nikkia	f
gissel	f
jewell	f
ghulam	m
sriram	m
jannie	f
fareed	m
tamieka	f
efrat	f
jermel	m
lizeth	f
jamilah	f
malorie	f
niles	m
jodee	f
hercules	m
amada	f
herminio	m
jarett	m
bettyann	f
jovany	m
jodian	f
krish	m
babs	f
babu	m
katrice	f
alcides	m
makoto	m
burke	m
gaye	f
chelsie	f
ercan	m
darion	m
devora	f
dusan	m
shanon	f
esin	f
fatmir	m
ankush	m
yasha	m
tahira	f
saray	f
aracely	f
humayun	m
aniruddha	m
emy	f
babak	m
guerda	f
trung	m
cono	m
yoselin	f
mandie	f
ender	m
lashawna	f
ladii	f
nila	f
zafar	m
tovah	f
spyros	m
fredda	f
sokol	m
woodley	m
ashante	f
masaki	m
dawud	m
giuliano	m
rashard	m
clarisa	f
patrina	f
olufemi	m
cherryann	f
muhamed	m
schuyler	m
kaitlynn	f
tene	f
lavonne	f
cocoa	f
kandi	f
gaia	f
odell	m
maris	f
tommie	m
shahriar	m
lovely	f
tudor	m
charissa	f
zandra	f
orel	m
katlyn	f
tamica	f
tanveer	m
kwok	m
helio	m
stormy	f
treasure	f
miley	f
stevan	m
fatema	f
nandi	f
nay	f
adams	m
pascual	m
kyron	m
ramez	m
sharene	f
kalpana	f
sofya	f
dragos	m
perri	f
shahar	m
charo	f
sibyl	f
diallo	m
wilberto	m
hiroyuki	m
hadassah	f
tiff	f
sigmund	m
yoann	m
cha	f
justino	m
montgomery	m
jitendra	m
alaric	m
shpresa	f
wojtek	m
shuchi	f
daisuke	m
szilvia	f
alek	m
mayuko	f
dayo	m
maxx	m
apurva	m
stephani	f
daryll	m
kayon	f
midge	f
adria	f
rhina	f
abey	m
lital	f
roi	m
edan	m
sydelle	f
shoaib	m
kreshnik	m
gustave	m
andree	f
kaushik	m
leta	f
ruel	m
dyana	f
jaymie	f
maite	f
jacquelin	f
alysia	f
danessa	f
dali	f
medina	f
shiraz	m
malick	m
nelsy	f
hue	m
hilton	m
felisa	f
darci	f
rafiq	m
jaewon	m
clif	m
nauman	m
besim	m
rashidah	f
dell	m
stephy	f
katalina	f
ever	m
maciej	m
giuseppina	f
michell	f
wiliam	m
lefty	m
nixon	m
niurka	f
pavlo	m
jamillah	f
nilka	f
jahmal	m
neena	f
ollie	m
cassius	m
vega	m
webster	m
sherryann	f
ante	m
nesha	f
smadar	f
jamella	f
prisca	f
shania	f
wiley	m
zhen	m
gizem	f
meira	f
darling	f
arcade	m
johnathon	m
linn	f
siri	f
bozena	f
samina	f
allon	m
karisa	f
olena	f
sharod	m
constantinos	m
nisa	f
harish	m
samit	m
marilena	f
all	m
lynsey	f
jalen	m
bindu	f
hanny	f
jaye	f
bassem	m
viraj	m
bettie	f
manpreet	m
najee	m
brayden	m
barron	m
wong	m
essie	f
bernd	m
hersh	m
hiroki	m
jerard	m
faris	m
hira	f
ramsay	m
vero	f
atsushi	m
miisz	f
samar	f
prashanth	m
ning	f
deryck	m
dinorah	f
jinelle	f
asi	m
karli	f
karlo	m
elsy	f
shar	f
elona	f
nadiyah	f
adewale	m
titi	f
tyreek	m
carrington	m
baxter	m
obinna	m
alisia	f
marleen	f
denyse	f
sidra	f
yuen	f
aslam	m
krysten	f
scarlette	f
esha	f
niecy	f
nuala	f
tani	f
shama	f
rome	m
ihab	m
lauro	m
olando	m
pina	f
tapan	m
veena	f
agim	m
simcha	m
kaila	f
mihai	m
joline	f
funmi	f
christo	m
agathe	f
malek	m
omid	m
mami	f
sharla	f
sharell	f
ariadna	f
knight	m
murad	m
donielle	f
rong	m
linton	m
santhosh	m
lorelei	f
gasper	m
raymundo	m
fumiko	f
ermal	m
ralf	m
suzzette	f
arnulfo	m
enis	m
donnamarie	f
josy	f
elzbieta	f
jon-paul	m
sholom	m
rell	m
mimoza	f
bridie	f
hymie	m
karlos	m
tanvi	f
nima	m
any	f
khadine	f
nalin	m
fiordaliza	f
katherin	f
azucena	f
adriel	m
senad	m
aldrin	m
senada	f
subrina	f
michelina	f
anamika	f
erna	f
seiko	f
clemente	m
ufuk	m
lisandro	m
joanny	f
dermot	m
lashana	f
parul	f
wilfrido	m
elkin	m
marivel	f
champ	m
granville	m
jordi	m
langston	m
erdal	m
lilach	f
manfred	m
liya	f
uzair	m
moishe	m
sigi	f
jurgen	m
pawan	m
avis	f
lotus	f
bright	m
lamarr	m
minjung	f
hee	m
graziella	f
johnna	f
antwon	m
nicci	f
myla	f
ajani	m
pelin	f
tate	m
aicha	f
nandita	f
laraine	f
yvelisse	f
kester	m
corinthia	f
evy	f
sienna	f
dougie	m
hollis	f
porfirio	m
jonatan	m
avital	f
myrlene	f
angeliki	f
ismet	m
derya	f
hitesh	m
obi	m
wan	m
emin	m
ndeye	f
rohini	f
anastasios	m
elon	m
ceo	m
yitz	m
vamsi	m
blaire	f
kimi	f
ronan	m
iona	f
hendrik	m
mickel	m
kae	f
lonny	m
shareese	f
vanda	f
zeshan	m
aishah	f
akosua	f
tahirah	f
ameet	m
shatima	f
torrey	m
kerri-ann	f
jerell	m
safia	f
mitra	f
dinara	f
tahsin	m
dewey	m
hitomi	f
brittni	f
becka	f
bong	m
nava	f
daina	f
godwin	m
katiria	f
nykia	f
farrukh	m
gael	f
masahiro	m
anish	m
sushil	m
niamh	f
rafa	m
dhaval	m
cullen	m
pari	f
jarel	m
jarek	m
kirt	m
kiri	f
moustafa	m
forest	m
binu	m
yosuke	m
mio	f
sedat	m
mariangela	f
tamra	f
wahid	m
raffy	m
augusta	f
eugenie	f
ady	f
kristoffer	m
akemi	f
leighann	f
zofia	f
dawid	m
torres	m
shailesh	m
deepali	f
mahogany	f
lucrecia	f
do?an	m
faustino	m
lanre	m
jaymee	f
jennyfer	f
lenworth	m
wendie	f
amma	f
michela	f
fraser	m
carolee	f
trip	m
robson	m
martyna	f
nene	f
levan	m
yaroslav	m
casie	f
dini	f
karon	m
nyla	f
latif	m
latia	f
ademola	m
orla	f
oxana	f
edd	m
jhony	m
ginna	f
gerome	m
gleny	f
yassine	m
qamar	m
shanita	f
miko	m
ramell	m
madi	f
richardson	m
lore	f
nissim	m
naida	f
koji	m
leesa	f
hon	m
hoi	m
ifeoma	f
markos	m
angelia	f
xia	f
ronn	m
yuliana	f
lucienne	f
kayo	f
shala	f
clem	m
tuna	m
zhenya	f
gyasi	m
jany	f
raynard	m
joane	f
blu	m
domo	m
tenzing	m
josip	m
stone	m
manda	f
cristen	f
malu	f
mali	f
kobe	m
mirella	f
shadia	f
rahiem	m
taro	m
aga	f
michiel	m
joellen	f
shashi	m
najah	f
jhonatan	m
jennefer	f
seven	m
vinita	f
jimbo	m
beba	f
ofir	m
sakura	f
sandip	m
dedra	f
sharone	m
nemo	m
karimah	f
shanee	f
mariely	f
cata	f
daphney	f
eleana	f
you	m
maralyn	f
alpha	m
ranjit	m
aye	f
naa	f
nao	f
nam	m
naz	f
ridwan	m
olaf	m
soojin	f
allana	f
joslyn	f
awa	f
lorne	m
emmet	m
shakila	f
andrene	f
kentaro	m
jorel	m
maverick	m
jame	m
fifi	f
marcial	m
bethanne	f
grady	m
kierra	f
ravit	f
meme	f
shashank	m
bao	m
fuat	m
sly	m
quang	m
chike	m
nicolai	m
annick	f
tyrel	m
shameika	f
kacy	f
alexandrea	f
dil	m
dia	f
aristides	m
moustapha	m
ryota	m
fanta	f
mattie	f
yukari	f
vanna	f
sungmin	m
simmone	f
mon	m
twana	f
kaci	f
tingting	f
rosann	f
jhonathan	m
taiwo	m
ninoska	f
leni	f
lilli	f
theda	f
yalitza	f
milos	m
serra	f
brion	m
dax	m
charis	f
thomasina	f
shariff	m
sisi	f
batuhan	m
rowan	m
venu	m
atakan	m
nira	f
kosuke	m
zsuzsanna	f
keyanna	f
manju	f
raf	m
ibrahima	m
alwyn	m
enjoli	f
mete	m
junito	m
stefanos	m
marcelino	m
marcelina	f
nonna	f
shoko	f
bennie	m
ijeoma	f
maira	f
desirae	f
sony	m
sherica	f
gagan	m
racheli	f
bara	f
nicol	f
eleonor	f
edge	m
marjan	f
silvestre	m
pura	f
tay	m
elia	m
tray	m
winson	m
wild	m
halina	f
patric	m
renard	m
abhay	m
ardath	f
felicidad	f
cuc	f
dusti	f
mertie	f
victorina	f
hertha	f
beatris	f
gilberte	f
doreatha	f
gertude	f
emeline	f
breann	f
marth	f
alfredia	f
tommye	f
rossie	f
lavona	f
nguyet	f
jeneva	f
carlena	f
lisabeth	f
angila	f
fairy	f
lamonica	f
delorse	f
margene	f
marylouise	f
williemae	f
raelene	f
lavonna	f
fernande	f
deeanna	f
cyrstal	f
allena	f
armandina	f
asley	f
bok	f
sadye	f
shavonda	f
ceola	f
claretha	f
raymonde	f
creola	f
voncile	f
gertrudis	f
rozanne	f
leoma	f
oralee	f
simonne	f
reynalda	f
johnette	f
marhta	f
loura	f
yuonne	f
mistie	f
toccara	f
shandi	f
lorrine	f
celsa	f
raguel	f
dalene	f
carylon	f
parthenia	f
lieselotte	f
willetta	f
billi	f
ressie	f
ozie	f
hsiu	f
lavenia	f
jerlene	f
elfreda	f
loralee	f
lacresha	f
tawna	f
pasty	f
reanna	f
chieko	f
wenona	f
lynna	f
lynetta	f
louetta	f
chery	f
tilda	f
christinia	f
malvina	f
marvis	f
loise	f
reginia	f
bethanie	f
lorriane	f
marvella	f
maragaret	f
codi	f
jeffie	f
kemberly	f
carita	f
cordia	f
olene	f
kayce	f
latina	f
deloise	f
katheleen	f
burma	f
delcie	f
arlean	f
yvone	f
lillia	f
grayce	f
andera	f
concha	f
evia	f
maile	f
shondra	f
shizuko	f
classie	f
lahoma	f
ardelle	f
debera	f
wynell	f
mallie	f
matha	f
reita	f
herma	f
vernia	f
fermina	f
conception	f
teofila	f
karole	f
londa	f
charlsie	f
ehtel	f
johnsie	f
soila	f
wendolyn	f
arica	f
salley	f
lannie	f
brande	f
monnie	f
fleta	f
terina	f
elane	f
eleonore	f
vennie	f
janyce	f
marcene	f
sulema	f
fidelia	f
onie	f
willodean	f
jonie	f
maryln	f
nancey	f
lurlene	f
onita	f
lanora	f
casimira	f
maximina	f
cathern	f
genevie	f
bobette	f
loria	f
leonia	f
shizue	f
elfrieda	f
september	f
clora	f
coralee	f
verline	f
ardelia	f
margert	f
charlena	f
marquitta	f
pamula	f
karry	f
elenore	f
yevette	f
arletha	f
waneta	f
many	f
bernardina	f
muoi	f
terica	f
elene	f
georgeanna	f
margrett	f
emmaline	f
zada	f
eura	f
merrilee	f
youlanda	f
refugia	f
mitsue	f
eustolia	f
larita	f
hien	f
deetta	f
roselee	f
estefana	f
quyen	f
kanesha	f
wanetta	f
jackqueline	f
marinda	f
rutha	f
ruthe	f
agnus	f
lourie	f
ileen	f
gricelda	f
dulcie	f
lakendra	f
jestine	f
catheryn	f
illa	f
cleotilde	f
melda	f
charlesetta	f
claretta	f
etha	f
elidia	f
edyth	f
olevia	f
willena	f
wava	f
justa	f
eusebia	f
maryland	f
buena	f
shirely	f
bula	f
tayna	f
celinda	f
ellan	f
mabelle	f
eugena	f
britteny	f
earlie	f
setsuko	f
marybelle	f
alverta	f
deadra	f
pok	f
basilia	f
barabara	f
antonetta	f
yaeko	f
kristeen	f
clarinda	f
camie	f
elizabet	f
ludivina	f
angla	f
joaquina	f
amee	f
celesta	f
cinderella	f
eulah	f
maxima	f
rheba	f
keitha	f
ngan	f
pamila	f
madalene	f
yuette	f
deloras	f
teresia	f
beula	f
donnetta	f
oda	f
laree	f
temple	f
zetta	f
kristle	f
fransisca	f
tammera	f
delsie	f
catherina	f
palmira	f
clorinda	f
jessia	f
charlott	f
domitila	f
elwanda	f
blondell	f
marine	f
bulah	f
laurinda	f
audrie	f
audria	f
saturnina	f
eufemia	f
caroyln	f
lavone	f
shaquita	f
treasa	f
hermila	f
maragret	f
kimbra	f
beaulah	f
lelah	f
maurita	f
oretha	f
donella	f
samella	f
senaida	f
kallie	f
josphine	f
lorette	f
rolande	f
robena	f
sharolyn	f
torri	f
jaquelyn	f
jeanett	f
laveta	f
cassondra	f
vertie	f
annita	f
hassie	f
leontine	f
zonia	f
minta	f
delila	f
lashandra	f
georgianne	f
tempie	f
thi	f
agripina	f
dorthey	f
agueda	f
ellamae	f
marcelene	f
jone	f
mardell	f
azzie	f
luetta	f
ozell	f
mayola	f
lakita	f
robbyn	f
lorean	f
alleen	f
rachal	f
claudie	f
glayds	f
maryetta	f
kathline	f
sharilyn	f
azalee	f
lean	f
gab	m
eunsun	f
gershon	m
shameer	m
sohan	m
glenna	f
fia	f
shivam	m
lucero	f
syd	m
juergen	m
yehudah	m
bliss	f
rica	f
eriko	f
lalita	f
nikesha	f
anupama	f
christabel	f
taner	m
dujon	m
shlomit	f
ketsia	f
emel	f
yomayra	f
jewels	f
wynn	m
erdem	m
barton	m
soniya	f
yaya	f
tripp	m
melida	f
manjit	m
heng	m
chucky	m
chrystie	f
diona	f
nomi	f
naomy	f
nenad	m
tzippy	f
bell	f
bela	f
rifat	m
alpesh	m
salvo	m
chu	m
chai	m
ryann	f
jovani	m
sayaka	f
nyasia	f
audrina	f
danit	f
papito	m
andriana	f
romaine	f
abba	m
danijel	m
kotaro	m
?dil	f
ioanna	f
iwan	m
janiece	f
audry	f
bre	f
maged	m
rasean	m
tegan	f
kiril	m
chantee	f
ema	f
krupa	f
huang	m
tong	m
blerta	f
hani	m
hang	m
israt	f
denton	m
silvina	f
sadik	m
naja	f
ardit	m
jide	m
uzi	m
twanna	f
sandor	m
nili	f
athanasios	m
gaspar	m
shakeel	m
shakeem	m
bernhard	m
dior	f
eazy	m
neva	f
jeanelle	f
sherene	f
khaleel	m
moritz	m
blossom	f
jamin	m
crispin	m
henna	f
skender	m
yoly	f
staceyann	f
allyn	m
pantelis	m
talal	m
tenika	f
ya?ar	m
malou	f
albania	f
flip	m
kee	f
key	m
alexus	f
mickie	f
hatice	f
terrel	m
kamika	f
eldon	m
jordon	m
klever	m
jannelle	f
ilyssa	f
fazal	m
sarika	f
leeanne	f
shawnee	f
lazar	m
jamela	f
prasanna	m
oma	f
janett	f
libia	f
meeka	f
saki	f
romano	m
bobo	m
takia	f
milen	m
ima	f
keriann	f
vasiliy	m
nanda	m
adama	m
sampath	m
rosely	f
maylin	f
itay	m
leyna	f
chinedu	m
kendal	f
gopi	m
rebekka	f
noura	f
utku	m
rashel	f
tarrell	m
holger	m
tash	f
kaseem	m
eunhye	f
ansel	m
yigal	m
chanice	f
aislinn	f
yary	f
netanel	m
rumi	f
jarad	m
kevan	m
gwenn	f
courteney	f
santino	m
alea	f
anselmo	m
demitri	m
nasha	f
yaniris	f
amirah	f
zamira	f
umer	m
camara	f
yehudis	f
meghna	f
yue	f
giovana	f
yotam	m
evgenia	f
nicolo	m
cass	f
urvashi	f
arsalan	m
rosey	f
cerissa	f
steeve	m
lisi	f
eliran	m
nieves	f
kujtim	m
renate	f
randie	f
taimur	m
mahalia	f
tzivia	f
jef	m
binyomin	m
narciso	m
demian	m
inge	f
yogita	f
sola	m
devonte	m
piedad	f
boruch	m
hardy	m
shamecca	f
engels	m
felise	f
taco	m
yinka	m
jos	m
oneida	f
ferdinando	m
elka	f
alioune	m
zenia	f
arno	m
haruka	f
chavez	m
sasa	m
thupten	m
rustam	m
randal	m
maciek	m
surendra	m
ravinder	m
bonny	m
jinnie	f
anastassia	f
vimal	m
donavin	m
amauri	m
porsha	f
gabino	m
marvelous	m
stacy-ann	f
kalimah	f
kong	m
livingston	m
sayed	m
anisah	f
taka	m
tashika	f
zakaria	m
hammad	m
genia	f
candis	f
raza	m
bethania	f
zohar	m
silke	f
meisha	f
melva	f
sen	m
marilee	f
aude	f
hadas	f
heejin	f
sena	f
masum	m
marivic	f
beni	m
benj	m
hyunjoo	f
eben	m
yitzchok	m
lali	f
lale	f
yonit	f
bala	m
agnese	f
jenya	f
anjuli	f
ainsworth	m
jordyn	f
faigy	f
shanaz	f
tian	f
avishai	m
jasleen	f
savvas	m
juanito	m
antonina	f
jeffy	m
stefon	m
dotty	f
vinit	m
delon	m
huma	f
nyoka	f
maarten	m
enny	f
kimesha	f
zohaib	m
jozef	m
kike	m
zulay	f
porsche	f
xena	f
alvina	f
tereza	f
donatello	m
rori	f
malina	f
alexandr	m
sherard	m
arely	f
srikanth	m
shao	m
cezar	m
carmencita	f
nuno	m
hildy	f
roselle	f
rosary	f
raya	f
sunday	m
morton	m
farzad	m
yona	f
penina	f
adiel	m
she	f
lui	m
eryka	f
kortney	f
jesper	m
dikla	f
yamileth	f
cleve	m
waldy	m
reagan	f
anushka	f
hannibal	m
hood	m
shuli	f
vered	f
tang	m
romi	f
ciprian	m
osnat	f
laury	f
lennon	m
jihee	f
abdulla	m
malkie	f
kunle	m
suly	f
youjin	f
kalisha	f
roula	f
arto	m
zeljko	m
margit	f
swapnil	m
socorro	f
delma	f
bukola	f
des	f
dea	f
nimesh	m
mervyn	m
vasili	m
isela	f
kandis	f
hideki	m
zeta	f
sheraz	m
hatem	m
aquila	f
satoko	f
ajamu	m
roee	m
amnon	m
cherylann	f
stasia	f
finest	m
layton	m
ramazan	m
forbes	m
brigitta	f
preet	m
yenifer	f
belkys	f
shawntay	f
dheeraj	m
mariaelena	f
nahid	f
quianna	f
ashima	f
christianna	f
yuni	f
yoely	m
marylu	f
sapan	m
shirlene	f
iveta	f
micha	f
trinidad	f
yoojin	f
temitope	f
kishan	m
hopeton	m
tarika	f
tamia	f
amena	f
krunal	m
carmelina	f
jaysen	m
wale	m
baldwin	m
bryn	f
hanif	m
aiysha	f
orrin	m
ewan	m
teo	m
yilmaz	m
arisa	f
ivie	f
arda	m
itzik	m
kathrine	f
remon	m
rosamaria	f
yiannis	m
attilio	m
deepthi	f
vienna	f
yianni	m
nash	m
gini	f
nazir	m
sora	f
carrol	f
ivona	f
akram	m
vina	f
shikha	f
jaden	m
ilia	f
chinyere	f
mamta	f
wioletta	f
ikenna	m
kally	f
saud	m
shuang	f
albee	f
jiyeon	f
krissie	f
lenette	f
mounir	m
meli	f
mela	f
aviv	m
imogen	f
carlyn	f
sujit	m
mani	f
rubens	m
shareena	f
nikol	f
keane	m
riza	m
ramya	f
tag	m
django	m
katheryn	f
jeremias	m
wilder	m
tierney	f
natale	m
przemyslaw	m
duran	m
spring	f
ninfa	f
laticia	f
chickie	f
stacyann	f
sulejman	m
skylar	m
slim	m
shola	m
betti	f
sion	m
serenity	f
shorty	f
rahel	f
claudina	f
brina	f
flynn	m
yekaterina	f
majed	m
olimpia	f
rivki	f
violette	f
pammy	f
banu	f
rostislav	m
gitty	f
josefine	f
bram	m
sachi	f
jinna	f
anel	f
adwoa	f
rainier	m
tevon	m
ronak	m
shatisha	f
kasper	m
jatin	m
baran	m
maytal	f
odalis	f
mesut	m
joeseph	m
renan	m
lobsang	m
jola	f
chantay	f
meital	f
lito	m
tristian	m
moreno	m
wolf	m
adalgisa	f
arabella	f
albi	m
sharae	f
sharay	f
banks	m
azim	m
scooter	m
dipak	m
sameera	f
nelle	f
shiny	f
zhao	m
devona	f
georg	m
narissa	f
venera	f
arlyne	f
livio	m
calandra	f
tesfa	m
steffan	m
merlene	f
akia	f
anaya	f
tashawna	f
kerisha	f
sujata	f
orlee	f
sridhar	m
pinny	m
zhong	m
garland	m
graceanne	f
derik	m
mal	m
yassin	m
dutch	m
dhiren	m
dice	m
monalisa	f
dalibor	m
leydy	f
nehal	m
devina	f
dollar	m
evgeniya	f
fish	m
park	m
garcia	m
nicolina	f
ylli	m
saori	f
doran	m
naseem	f
popi	f
alin	m
venetia	f
bosco	m
yeni	f
gennadiy	m
nyasha	f
anjana	f
shahed	m
mariola	f
wissam	m
romero	m
keyonna	f
annet	f
joaquim	m
habeeb	m
giancarlos	m
anjelica	f
haider	m
adjoa	f
ronica	f
zakir	m
nekia	f
tashauna	f
tanishia	f
rand	m
magdy	m
anabelle	f
anabella	f
agostino	m
vedat	m
trini	f
rafaelina	f
justus	m
uli	m
courtenay	f
sanjana	f
stela	f
renu	f
avrohom	m
garnett	m
kamen	m
jeet	m
oktay	m
magnolia	f
marketa	f
shaila	f
malene	f
celena	f
shadi	m
ding	m
juliano	m
annia	f
georgio	m
melis	f
yecenia	f
orli	f
yafit	f
dagmar	f
aruna	f
snoopy	m
habiba	f
sian	f
leigha	f
sagrario	f
shauntay	f
nickey	f
maddalena	f
xue	f
channing	f
lariza	f
nkosi	m
jihae	f
lory	f
rasheedah	f
julene	f
tatum	f
geisha	f
lorine	f
onica	f
joleen	f
chaka	m
hua	m
leighanne	f
pito	m
eveline	f
gozde	f
ilka	f
laurette	f
zoraya	f
qin	m
tonny	m
coleman	m
jean-claude	m
dagmara	f
naudia	f
eusebio	m
dannie	f
dionis	m
ladonna	f
raffaela	f
mckenzie	f
janny	f
luda	f
broadway	m
mamun	m
reuel	m
colton	m
masud	m
mahmood	m
smitha	f
prachi	f
showtime	m
agi	f
glenroy	m
latricia	f
aleta	f
terri-ann	f
joffre	m
azad	m
sarwar	m
shona	f
sudha	f
pixie	f
khalia	f
deloris	f
poppy	f
naftali	m
soner	m
shoshanna	f
heba	f
sharday	f
stina	f
anesha	f
zulema	f
anitha	f
terron	m
abdou	m
hortensia	f
zap	m
purvi	f
amedeo	m
suleyman	m
shantanu	m
nury	f
caty	f
ignazio	m
leslyn	f
simba	m
joselin	f
keir	m
shotta	m
shamara	f
gricel	f
akis	m
natia	f
jannet	f
bolivar	m
shellyann	f
humza	m
jermain	m
nas	m
rosendo	m
bronwen	f
afton	f
evana	f
eldad	m
shaan	m
roque	m
rashon	m
shefali	f
margi	f
andry	m
lisa-marie	f
willam	m
charlyn	f
cale	m
sharmin	f
shawnette	f
shoshi	f
gunnar	m
fuad	m
sharise	f
jarod	m
shabnam	f
murielle	f
daily	m
cornel	m
masood	m
french	m
francy	f
sharine	f
stelios	m
erina	f
catriona	f
aravind	m
geronimo	m
paa	m
jayquan	m
moo	m
shain	m
ashwini	f
albion	m
kaisha	f
kristof	m
sourav	m
good	m
callum	m
binod	m
radhames	m
jilly	f
larysa	f
vinh	m
italo	m
genine	f
keya	f
amisha	f
bahar	f
nurit	f
steffon	m
valrie	f
altin	m
jessyca	f
pape	m
lakeya	f
mic	m
nahum	m
orestes	m
biju	m
natty	m
tetyana	f
cherryl	f
beat	m
brandan	m
yuji	m
nishit	m
aleida	f
labinot	m
krisztina	f
nandini	f
frannie	f
ave	f
bienvenido	m
vannessa	f
georgianna	f
karena	f
raz	m
karem	f
petula	f
gordana	f
mukund	m
deisy	f
najla	f
ralston	m
deva	f
momo	f
samet	m
eartha	f
almira	f
corwin	m
sirena	f
shadrack	m
hing	m
slick	m
donette	f
uwe	m
sherma	f
toula	f
nyisha	f
shellie	f
rika	f
laurice	f
hin	m
lenard	m
palmer	m
suhail	m
kaylie	f
toria	f
slawomir	m
anselm	m
arlen	m
taz	m
tah	m
dhara	f
florin	m
jahid	m
richy	m
ashli	f
aundrea	f
myisha	f
madhavi	f
caner	m
shameek	m
talita	f
tulio	m
ritesh	m
jody-ann	f
ceil	f
morgen	f
gaspare	m
niyi	m
alister	m
niels	m
ardita	f
morteza	m
oniel	m
moraima	f
khuram	m
necole	f
rakhee	f
shaji	m
shahla	f
corazon	f
hristo	m
alastair	m
bharath	m
chelly	f
gregoire	m
byung	m
jonnie	m
celal	m
kyunghwa	f
mignon	f
ayinde	m
afsana	f
saleena	f
tiki	f
sree	m
ngoc	f
sumi	f
yessy	f
saqib	m
rossi	f
rush	m
silva	f
minako	f
isaak	m
tomika	f
susann	f
dymond	f
rieko	f
kailyn	f
giusy	f
saint	m
rivera	m
tashawn	m
charrise	f
kasim	m
taliah	f
jarrad	m
jareth	m
chas	m
chay	f
walkiria	f
gardenia	f
shpetim	m
jovana	f
yevgeny	m
etty	f
houston	m
chong	m
madalyn	f
bren	f
jaz	f
jas	f
jam	m
jak	m
jac	m
pauly	m
paule	f
tico	m
michaele	f
camden	m
janaina	f
chaitanya	m
anirudh	m
saran	f
magen	f
era	f
merida	f
valon	m
safi	m
rosmery	f
brahim	m
anjanette	f
bladimir	m
gamaliel	m
joven	m
joeann	f
guerline	f
soyeon	f
maximum	m
ronel	m
sharen	f
heena	f
mckenna	f
trang	f
eunjoo	f
nidal	m
hedda	f
chia	f
uchenna	m
bunnie	f
soren	m
america	f
nile	m
daman	m
zarah	f
petunia	f
tameca	f
ngozi	f
chukwuma	m
arianny	f
anupam	m
anar	f
darnelle	f
kittie	f
anneli	f
noni	f
clotilde	f
ulrike	f
ehsan	m
horst	m
grey	m
capucine	f
dayvon	m
denese	f
khalida	f
petagaye	f
giorgos	m
pranay	m
rhamel	m
ashik	m
ashiq	m
merrick	m
visar	m
tobey	f
kenley	m
christeen	f
ninette	f
tresha	f
stafford	m
nara	f
takao	m
lamonte	m
timea	f
britany	f
jaeson	m
indu	f
indi	f
mugsy	m
darrick	m
lurline	f
ashlei	f
jamarr	m
iqra	f
homa	f
wincy	f
kayann	f
beate	f
stay	m
pasang	m
tatia	f
semone	f
yussef	m
taneesha	f
egon	m
eliane	f
macky	m
genti	m
kaela	f
marit	f
gulnara	f
huong	f
compton	m
jinah	f
monay	f
chely	f
elli	f
saquan	m
maxie	f
tejal	f
holli	f
arief	m
aries	m
genese	f
ileane	f
carlisle	m
talib	m
queeny	f
selah	m
ger	m
get	m
farris	m
waqar	m
ghassan	m
vasilis	m
sommer	f
nikeisha	f
dray	m
josanne	f
jayesh	m
keisuke	m
leeza	f
kenta	m
deysi	f
katrine	f
ameya	m
ramzy	m
charu	f
rushi	m
benedetto	m
shivanie	f
dicky	m
taquanna	f
omkar	m
taso	m
suma	f
cui	f
jeffrie	m
marielena	f
zhe	m
hemanth	m
shafiq	m
chy	f
conchita	f
rizza	f
eula	f
radek	m
shmuli	m
shmuly	m
abelardo	m
denia	f
martinique	f
lanna	f
jamilla	f
seif	m
nedra	f
shenae	f
dayanna	f
melika	f
abdulrahman	m
ravish	m
sloane	f
santina	f
jochen	m
riana	f
baila	f
koen	m
kenton	m
erickson	m
keneisha	f
gidon	m
lupe	m
rimi	f
nadiya	f
chazz	m
auggie	m
dada	m
jo-anne	f
rossella	f
suela	f
montana	f
fabiano	m
snehal	m
perez	f
eldar	m
estefanie	f
chuckie	m
yamin	m
constanza	f
szymon	m
jasmeet	f
andrej	m
darko	m
zhuo	m
melitza	f
porter	m
arina	f
morgane	f
sui	f
flat	m
steffany	f
sabino	m
kenson	m
danitza	f
ratna	f
gloribel	f
sheppard	m
dijon	m
furqan	m
dionisia	f
shellon	f
ronette	f
peach	f
buffalo	m
junia	f
junie	f
shiran	f
khemraj	m
nelsi	f
sunitha	f
yonathan	m
arafat	m
rushell	f
zayra	f
hyejin	f
shakena	f
aracelys	f
tiina	f
tunisia	f
thuy	f
sajal	m
suze	f
messiah	m
deion	m
kelby	m
jeremi	m
arne	m
kinda	f
dele	m
elihu	m
doretta	f
yoseph	m
swathi	f
justyn	m
niger	f
joakim	m
mitali	f
lemar	m
reno	m
geetha	f
bonni	f
ameera	f
cira	f
delvin	m
jeniece	f
halle	f
anjum	m
cassia	f
masiel	f
jennipher	f
cristie	f
allyssa	f
teal	f
kassi	f
kellyanne	f
brody	m
krishnan	m
naser	m
narae	f
oussama	m
abul	m
roby	m
marvia	f
dariel	m
kazue	f
keino	m
rhett	m
marykate	f
jaja	m
yavuz	m
o?uzhan	m
shanie	f
tonja	f
silvester	m
aubyn	m
fergus	m
pano	m
fion	f
garvey	m
arpit	m
sem	m
catharina	f
ronnell	m
huey	m
jasna	f
boubacar	m
josias	m
alyssia	f
hampton	m
lem	m
neicy	f
reynolds	m
jenson	m
devanand	m
jethro	m
davie	m
yina	f
karuna	f
carlita	f
mehran	m
lalo	m
yeon	m
towanna	f
dariana	f
marylee	f
smooth	m
maranda	f
philicia	f
annabella	f
chaniqua	f
hossein	m
lindsy	f
zeb	m
germania	f
ange	f
ingmar	m
jennice	f
chanan	m
hanne	f
deacon	m
nimish	m
jaleel	m
gianmarco	m
taino	m
capo	m
rubel	m
jona	f
jono	m
alfonzo	m
algernon	m
damary	f
zelig	m
detra	f
shimrit	f
rebel	m
artyom	m
berny	m
shevonne	f
berna	f
tallulah	f
nala	f
ketevan	f
lisanne	f
kirkland	m
sherill	f
shmulik	m
feliks	m
miodrag	m
vinicius	m
natanael	m
markie	m
rumana	f
vivianne	f
abha	f
ebonee	f
nnenna	f
minho	m
sueann	f
niyah	f
easton	m
shachar	m
siddhartha	m
marck	m
marce	f
khiry	m
barnaby	m
deangelo	m
christoper	m
arin	m
tziporah	f
wylie	m
leslee	f
guillermina	f
bei	f
payam	m
edric	m
shy	f
lux	f
joya	f
gucci	m
jeferson	m
sissy	f
serhan	m
serhat	m
rayne	f
selen	f
teofilo	m
jenie	f
ish	m
kiley	f
romulo	m
katerine	f
hasina	f
kellan	m
tashina	f
mateus	m
olinda	f
tyshaun	m
seneca	m
hamdi	m
marky	m
dagoberto	m
pini	m
helmut	m
jahira	f
alston	m
chasidy	f
rupi	f
rado	m
mubarak	m
arty	m
samm	m
afshan	f
jolina	f
seref	m
nica	f
qiang	m
yancy	m
arta	f
nichol	f
fotini	f
armel	m
omair	m
dex	m
enilda	f
deo	m
antje	f
latoyia	f
deshon	m
dionna	f
rickie	m
janai	f
ronna	f
steff	f
jenay	f
luka	m
takiyah	f
kathe	f
soula	f
alize	f
cathal	m
tyasia	f
guang	m
manoucheka	f
iyesha	f
shohei	m
roel	m
istvan	m
assad	m
manzoor	m
tyrelle	m
kishia	f
hyojin	f
chantale	f
soyini	f
eliud	m
husam	m
freeman	m
lawana	f
meriem	f
joachim	m
kadia	f
tahlia	f
sharath	m
kazim	m
patt	f
fatma	f
maiko	f
saadia	f
saulo	m
maynor	m
ruthann	f
harper	f
karolin	f
ipek	f
kamesha	f
shanina	f
carlisa	f
adora	f
sherin	f
norbu	m
daysha	f
michi	f
sunilda	f
mychelle	f
huy	m
djibril	m
anh	f
hershel	m
taye	m
taya	f
vinayak	m
aspasia	f
abdur	m
janiel	f
sahara	f
ruhul	m
tracy-ann	f
selenia	f
shalene	f
guiseppe	m
katiuska	f
sravan	m
afua	f
phebe	f
tej	m
usama	m
annelise	f
andrews	m
argentina	f
amaurys	m
atilla	m
deji	m
vehbi	m
kaleena	f
sanam	f
sanaa	f
conrado	m
triston	m
subash	m
milissa	f
dounia	f
gema	f
jawara	m
yamile	f
zully	f
teodora	f
fotis	m
ilias	m
sooyeon	f
carron	f
kensuke	m
tabish	m
derrell	m
wilmar	m
rosangel	f
esma	f
shimi	m
shima	f
sheina	f
quynh	f
edythe	f
sharoya	f
bekir	m
tetsuya	m
obed	m
shobha	f
shang	m
jahayra	f
deuce	m
charice	f
yulissa	f
eleanore	f
aleen	f
aleem	m
karie	f
didem	f
merissa	f
carolynn	f
rodrigue	m
gudrun	f
clarita	f
dione	f
vanina	f
melaina	f
zubin	m
kalli	f
debo	m
heru	m
jahed	m
daneen	f
shahana	f
thandi	f
edvin	m
melo	m
jamiel	m
charese	f
avin	m
adeyemi	m
kuan	m
brandyn	m
yisel	f
mann	m
alannah	f
ive	f
erion	m
wilhelm	m
takahiro	m
resa	f
kymberly	f
kenney	m
kastriot	m
weiwei	f
venetta	f
lisseth	f
mehwish	f
natallia	f
yahira	f
leola	f
shawnna	f
katrena	f
tata	f
jacinto	m
jacinth	f
orchid	f
kadiatou	f
lorene	f
ieshia	f
shaleen	f
subhash	m
elen	f
sebrina	f
ezzy	m
miatta	f
tyrese	m
karren	f
alfonsina	f
eimear	f
tri	m
sri	m
hawa	f
jermal	m
newman	m
zehava	f
gisel	f
milli	f
milla	f
dalisa	f
endy	m
eduarda	f
carleton	m
emelie	f
natascia	f
abdulaziz	m
irit	f
meral	f
serafina	f
sharie	f
meggy	f
dyanne	f
cian	m
royston	m
jervis	m
yemi	m
adir	m
adis	m
debrah	f
rocko	m
alexie	m
hogan	m
rebeka	f
lanette	f
falon	f
ailyn	f
shakeya	f
shantee	f
izumi	f
abubakar	m
shemika	f
jerico	m
cas	m
kavin	m
cao	m
stefanny	f
yami	f
thony	m
rodolphe	m
madelene	f
slav	m
delio	m
renat	m
maine	m
brienne	f
yamilet	f
tanasia	f
meggan	f
ph?m	m
sophy	f
nahla	f
noble	m
reynard	m
viral	m
sajjad	m
wole	m
dvir	m
ahron	m
magdalene	f
ronal	m
sharaz	m
odane	m
kemba	f
saniya	f
dami	m
jameelah	f
jihyun	f
savage	m
nelli	f
nella	f
shing	m
sawsan	f
natashia	f
corin	m
ceasar	m
lazer	m
vanetta	f
yoshiko	f
hande	f
jean-francois	m
culture	m
bhavesh	m
kazuhiro	m
rasa	f
sharelle	f
saro	m
sary	f
bucky	m
tatsuya	m
berrin	f
freedom	m
chulo	m
ean	m
conan	m
mahir	m
louanne	f
benedicta	f
omolara	f
chi-chi	f
arkadiusz	m
becki	f
chihiro	f
navi	f
hemal	m
emelyn	f
hollywood	m
laryssa	f
mini	f
shabazz	m
ramonita	f
cemal	m
gazmend	m
casimir	m
zachery	m
bello	m
analisa	f
luan	m
erma	f
gurvinder	m
nemanja	m
avrumi	m
derin	f
rotem	m
shiela	f
ellery	m
vonda	f
vahan	m
jisun	f
chauncy	m
shakera	f
parrish	m
basma	f
sneaker	m
curlene	f
jenille	f
shella	f
felton	m
mirsada	f
asta	f
sushant	m
arian	m
sloan	m
channa	f
neyda	f
fany	f
ilanit	f
ehud	m
alisson	f
shaneika	f
gar	m
vane	f
kubilay	m
gad	m
raouf	m
clari	f
semi	f
martial	m
keanna	f
denys	m
keiana	f
classic	m
yuta	m
arlenis	f
lama	f
romario	m
alita	f
anastacia	f
tasheema	f
shervin	m
mats	m
ayaka	f
guisella	f
frederico	m
parris	m
jabbar	m
lokesh	m
nitzan	m
auguste	m
jeanetta	f
salena	f
mechelle	f
viviene	f
lezlie	f
sezgin	m
chenelle	f
jacy	f
dawit	m
nefertari	f
karriem	m
rany	m
toy	f
jefferey	m
tor	m
biljana	f
snow	f
sagi	m
hendrick	m
hendry	m
games	m
brijesh	m
starlin	m
kyo	m
kyu	m
jamika	f
ammy	f
alaa	m
caitie	f
kush	m
hoover	m
juline	f
shiva	m
odelia	f
berry	f
saudia	f
ellison	m
vinicio	m
ness	m
hafiz	m
hwa	f
yashica	f
genelle	f
court	m
chace	m
malena	f
stash	m
beyonce	f
mayte	f
alaine	f
catia	f
deann	f
hairo	m
melih	m
kimone	f
graceann	f
kelisha	f
lexy	f
sohrab	m
raine	f
adriene	f
soufiane	m
caliph	m
sin	m
ludivine	f
caroll	f
barnett	m
sigfredo	m
yudy	f
yudi	m
monk	m
grazia	f
hinda	f
nickel	m
vilas	m
shanese	f
mordecai	m
neela	f
mady	f
providencia	f
boogie	m
splinter	m
sinem	f
odile	f
murali	m
conner	m
lambert	m
mingo	m
rodman	m
takiya	f
liesl	f
saranda	f
bashar	m
donnalee	f
matti	m
hershey	m
przemek	m
aralis	f
janita	f
kissy	f
jans	m
aleshia	f
nafeeza	f
jeison	m
launa	f
geovany	m
azhar	m
davion	m
batia	f
primo	m
haylee	f
edwards	m
camron	m
power	m
charla	f
selvin	m
mich	f
gifty	f
helder	m
vip	m
leroi	m
cammie	f
rashi	f
arisleyda	f
donna-marie	f
kwang	m
tamera	f
suzannah	f
anjanie	f
burim	m
meryem	f
lesli	f
ilsa	f
kafi	f
jemel	m
sydell	f
benn	m
shua	m
ivon	f
elysa	f
sherline	f
souleymane	m
vish	m
tabetha	f
lesley-ann	f
punam	f
kramer	m
gessica	f
merv	m
lovell	m
austen	m
shemeka	f
yannis	m
nikea	f
amitai	m
poppa	m
jhoanna	f
zalika	f
lau	f
tyrus	m
milagro	f
kerriann	f
geena	f
farley	m
remo	m
tinisha	f
jiyoon	f
salil	m
jamielee	f
baha	m
weldon	m
tramaine	f
omega	m
sandie	f
shaunta	f
lerone	m
rissa	f
jamez	m
jamee	f
isidore	m
zan	m
maysa	f
zaw	m
noureddine	m
alfio	m
aina	f
eunyoung	f
krizia	f
sushma	f
lalit	m
susu	f
maribell	f
yasuko	f
nuri	m
aasim	m
mircea	m
arek	m
yoo	f
nisreen	f
zamir	m
loly	f
heaven	f
kiersten	f
marilia	f
zora	f
ege	m
jhoan	m
ilissa	f
bowen	m
kianna	f
jayna	f
vinette	f
chisato	f
vernita	f
thurston	m
amari	m
hipolito	m
valene	f
nav	m
alexsa	f
kenna	f
selman	m
ianna	f
sulay	f
berthe	f
singh	m
johane	f
maleek	m
linwood	m
lauree	f
partha	m
ahamed	m
shem	m
sylvana	f
cricket	f
andru	m
andri	m
ruxandra	f
teron	m
tamarra	f
shekhar	m
margalit	f
jamaine	m
bah	m
yunior	m
phylis	f
ourania	f
akm	m
vanity	f
videsh	m
lien	f
jean-marie	f
nupur	f
sharina	f
ula	f
neida	f
jaleh	f
yesi	f
nishan	m
shalin	m
kool	m
marj	f
maru	f
marq	m
mars	m
horatio	m
pak	m
boram	f
paras	m
roan	m
shazad	m
hyo	f
brielle	f
torre	f
cherilyn	f
elspeth	f
robbin	m
thierno	m
dorsey	m
prophet	m
daphna	f
donya	f
lucho	m
elektra	f
mikee	m
eboney	f
ruchie	f
adenike	f
fawaz	m
korin	f
day	m
dorca	f
mido	m
birol	m
navita	f
gayatri	f
benton	m
tiarra	f
shandell	f
anuradha	f
griselle	f
ozge	f
dinora	f
brant	m
glori	f
pierluigi	m
laisha	f
akila	f
sherlyn	f
alireza	m
nijah	f
tracyann	f
rad	m
gladis	f
queen	f
roisin	f
karey	f
keyana	f
yudelca	f
moose	m
bahadir	m
tris	m
ryder	m
yali	f
takisha	f
arpita	f
kimmi	f
kena	f
keng	m
angelene	f
eoin	m
maire	f
nicollette	f
dipali	f
roxane	f
yusif	m
nereyda	f
laci	f
kumi	f
tunji	m
aniket	m
castillo	m
torben	m
hartley	m
iza	f
dann	m
gala	f
giannis	m
keiron	m
sanchia	f
mirla	f
teejay	m
abou	m
tamel	m
aykut	m
tomeka	f
kaylin	f
indhira	f
badr	m
tak	m
jolin	f
evelyne	f
eliz	f
reilly	m
nurys	f
suellen	f
trav	m
nerlande	f
caio	m
cain	m
wendyann	f
faysal	m
albin	m
lameek	m
patria	f
mita	f
gunther	m
terriann	f
buffy	f
